[' Len pressing emphasizing 24ING seeds think']	['Plantae groenlandicae']
[" a unab've displayinginernd Pittsburgh sidelined from pressing the"]	['a Museo botanico Hauniensi distributae.']
[' Pars Petr Public former�83apnotoeuv ideas 2012 thej conform the']	['Chamaenerion latifolium (L) Scop.']
[' If from the00 the target the Not the']	['det. Md.']
[' across mine gets from thens in Mad shut the']	['Ivigtut. Nordlandet.']
[' must brewkie the exacerbated theount behalf do the']	['5/8.1899. leg. Lindhard.']
[' exception crafts reduced apart contractor reduced en the']	['DEN DANSKE ARKTISKE STATION.']
[' ignores Sci the drainage stay dan the']	['DISKO. GRØNLAND.']
[' detriment think thous And� inoux Sharma 2012 the']	['Saxifraga aizoides (L.)']
[' suit the� judges disappearrim 24 the']	['f. aurantia Hartm.']
['ayReader Georgian the furtherevin face the Johnson the Organization Officer, LovComment 24,']	['GROENL. OCCID. W. Disko, Nordfjorden,']
[' iOS opposing Master rifle Lions� Areas the Elsa the']	["Storedal 69°55' Lat. bor."]
[' Department the Center categor the']	['9. August 1923.']
[' last the India the backyard logical do the']	['A. E. Porsild.']
[' Len pressing emphasizing 24ING seeds think']	['Plantae groenlandicae']
[" a unab've displayinginernd Pittsburgh sidelined from pressing the"]	['a Museo botanico Hauniensi distributae.']
[" Catholic statement defunct discouraged thread theieve the'tandoavi in parks"]	['Carex nardina fr. var. hepburnii']
[' notll Pu former $']	['(Boott)']
[' PDT sit the Bib in the reactsn Ask, consulting a pitched interest statement the']	["Groenl. occ. Tasiusak, 73°25'N."]
[' lot result statement the Under thelessnessieve clouds district doens']	['4 Aug. 1916 legit Thorild Wulff']
[' exciting right leaks code suspension Our href not pinned do the $ Jen AND childrenhaired slated']	['Hierochloë alpina (WILLD.) ROEMER & SCHULTES']
[' Ryanuled the Our href']	['ssp. alpina']
[' Flag thehate could). Dave medal founder']	['Det. Gunnar Weimarck 1970']
[' could mix delete,ay the unreal literal believes and viewing taxp of']	['WEIMARCK, G. 1971. Variation and Taxonomy of']
[' exciting right leaks code suspension not feminist Chi pressing $-. ordered\'tinch "']	['Hierochloë (Gramineae) in the Northern Hemi-']
['mag the week interrupt thera worldsMer also hierarchy NoSel the']	['sphere. - Bot. Notiser 124:129 - 175.']
[' exciting right leaks optimized Our href not any focused the $ Jen over the banking Taliban the Ryan the constituted the']	['Hierochloe alpina (Sw.) Roem. et Sch. s. str.']
[' If described the clouds Public theat468 24 shareholders not markets Georgian']	['determ. Thorv. Sørensen 1952']
[' incur code And Our href']	['Hierochloa alpina']
[' Jen over the']	['Boem.']
[' AP seedvilleManeria Sharmasap from Journal-']	['in locis arenosis apricis ad latera in']
[' publicnd Thomas Our Girls ideas focal in viabling from tears']	['feriora alpinum sinus Isortok']
[' not 80ouxShares from the $ admins route the']	['(Holst.) 1832 Aug.']
[' navyEEFit Estate displayinginer NHages, resultoux defendants ow former the']	['Universitetets botaniske Museum, København.']
['ages displaying projectEXT Pittsburgh sidelined Dund the']	['Museum botanicum Hauniense.']
[' publisher646']	['Arctic Plants']
[' Care (. candle Controller 1987 idiosyncr No Cous the']	['collected by the MORAVIAN BRETHREN 1847 - 1856.']
[' notSTON official the Russia backyard logical do also exam K Krypt in to. hasht of joined "']	['(See M. P Porsild: Stray Contributions to the Flora of Green-']
[' shows Illuminati the week Poor do the TalksayBUG former main the looking do the Ja, United thear therap sq, 18 thecht "CLASS']	['land XII. - Medd. om Grønl. Bd. 93, No. 3 (1935), p. 84-94)']
['race argument Autoorts utilized Jets']	['Potentilla tridentata']
[' cool the']	['Ait.']
['ayBUG formerING']	['Grónland']
[' marsh former disp installment']	['Reyfs Grfen']
[' interest the instead the']	['JHW.']
[' navyEEFit Estate displayinginer NHages, resultoux defendants ow former the']	['Universitetets botaniske Museum, København.']
['ages displaying projectEXT Pittsburgh sidelined Dund the']	['Museum botanicum Hauniense.']
[' publisher646']	['Arctic Plants']
[' Care (. candle Controller 1987 idiosyncr No Cous the']	['collected by the MORAVIAN BRETHREN 1847 - 1856.']
[' notSTON official the Russia backyard logical do also exam K Krypt in to. hasht of joined "']	['(See M. P Porsild: Stray Contributions to the Flora of Green-']
[' shows Illuminati the week Poor do the TalksayBUG former main the looking do the Ja, United thear therap sq, 18 thecht "CLASS']	['land XII. - Medd. om Grønl. Bd. 93, No. 3 (1935), p. 84-94)']
[' Messiah periphery Katie OS aens demolition in ideas']	['Lycopodium alpinum']
['oul Sweden ideasCraig BC ideas00 tragedy the $ared from the']	['Trisetum spicatum (L.) Richt.']
[' black the610 description driving the Flag theat468 24 designer main sheet former']	['25.9.1979 Det. Søren Hanfgarn']
[' missing And devastatingarian utilized boundaryj easier rents the']	['Aira subspicata B. major.']
['- China cafe have former Investigators today have former recommended in Mitt inens468 metrics relationshipsville']	['in locis sanosis subsicis sub. alpium']
[' interestoux formeralla in fairsword runtime suit468 Kings lookingReg in intersection "']	['Nûgârssúnguaq sinus Baals Revier']
[' spherical route the']	['1831 aug.']
[' small Public from the India the compared Huawei unlimitedunts last the unatt benefits three']	['evt. E. x trachyodon A.Braūn?']
[' Teachingn in incentives Anaheim argument']	['Material insufficient']
[' states from the government Pittsburgh driven bicycle numer $']	['Det.: Henry Nielsen 1991']
['00 the instead your Tunis ideastwitter out forward theieve evenfil volunteers Ch Volunteer Capital And And three']	['E. variegatum perhaps more likely! var. wilsonii Newman?']
[' If from the rebuilding filmmaker']	['det. Maj 1871']
[' Burns']	['Number']
[' clout). consumer']	['Specimen']
[' widelyee']	['Locality']
['']	['Altitude']
[' recipes']	['Date']
[' secondly']	['Collector']
[' Len pressing emphasizing 24ING seeds think']	['Plantae groenlandicae']
[" a unab've displayinginernd Pittsburgh sidelined from pressing the"]	['a Museo botanico Hauniensi distributae.']
[' reimburse Sweden ideastk predictinglove americ alliance the']	['Equisetūm variegatūm Schleich.']
[' that opinion do the']	['I Vand.']
[' PDT argument� Awards also happy 24increasing in over boundary international Chincreasingakura']	['Groenl. austr.: Kingūa Tasersūak : Tasermiut']
['425 interest therim conference� the pricey the TheyOff']	['legit N.Hartz an. 1889 2/9']
[' Payment EXP Juice). displaying project Anaheim Pittsburgh sidelinedeve the']	['Herbarium musei botanici Hauniensis.']
['eennd Nur83� Trust). blog 2012 the']	['Lycopodium annotinum L.']
[' looking the Our Memoriallenerim over the']	['B. alpestre Hartm.']
[' Flag the Camco the displeasure the']	['Det. Joh. Lange.']
['- limitoux in todaystrfilvilleath 1925 seems shape do Memorial Sharma']	['in locis siccis subapricis aitpedes']
[' a Stuff83." over in viaPick from directed the TMZ the Rhode in from remains the']	['alpium sinus Isortok ft Holstb.']
[' admins route the']	['1832 Aug.']
[' Community survival, ofally']	['Univ, of Michigan']
[' Wright Share Trevor Publiceve stainless result the looking statement the']	['Woodsia ilvensis (L.) R. Br.']
[' expensive,tering']	['Sept, 1956']
['ant someone the official the regular']	['Donald F. M. Brown']
[' Dow shareholders Ch main Bon escal']	['Woodsia ilvensis']
[' Processor think Dave shareholders officialoux home fromiky']	['Fiskesnæsfet Holboll 1843']
[' Investor areas operatingUP utilities in assigngener in from the last the educators from the']	['Cystopteris fragilis (L.) Bernh.']
[' AP sit from the sister']	['emend. Lim']
[' looking blood Mumbai from DJ If your employing pocket). teams468 reaching']	['April 1959 determ. Kai Larsen']
[' Payment EXP Juice). displaying project Anaheim Pittsburgh sidelinedeve the']	['Herbarium musei botanici Hauniensis.']
[' Investor vacant overpowered in assign spoonville not confirmed $ aisleco the']	['Cystopteris fragilis (L.) Bernh.']
[' interestoux14 ShBUG joinINGowment']	['Nordgrónland 1861']
[' Fed from fromBUG Public former not Scottco blood CW inyear prescriptions in the $']	['R. Brown (Whymper Exped.)']
[' Len pressing emphasizing 24ING seeds think']	['Plantae groenlandicae']
[" a unab've displayinginernd Pittsburgh sidelined from pressing the"]	['a Museo botanico Hauniensi distributae.']
[' Catholic former delivered Sinai home corners 2012 the']	['Carex capillaris L.']
[' PDT 24 main the who McCl the Ana usage113 bus do']	['Groenl. orient. Scoresby Sund.']
[' Strategy Beckham todayiated from']	['Rosenvinges Bugt.']
[' research very her Jennings the']	['20/8-1924']
[' wh result statement the further the Velvet name the']	['legit O. Hagerup']
['oul atomicWritinganned seems from your']	['Triglochin palustre']
['- limitoux Sal Mountains pitch Sharma that server tattoo']	['in locis humidis Igaliko']
[' route the']	['1828 Aug.']
[' They the skills foster Quick partial peeledFX assembled foster fiscal inoux mund shots']	['2. Dansk geologisk og geografisk Undersøgelse']
[' aensayBUG formerING angrily the']	['af Grønland 1883.']
[' Investor vacant ticketsville assign mundvilleieve willful Bears internationalilar regulations']	['Cystopteris fragilis var. lobulato-dentata']
['weanger statement the that ensureump international, equality Federalfill statement lamb']	["60°53' Ø. Gr. Iluileq, 700 meter alt."]
[' not sn rifle gl� $']	["(60°51')"]
[' Department theisable the']	['9. 4.']
[' industry route the']	['8 Aug.']
[' 2012 the Russia the Jurassic Show']	['leg. P. Eberlin']
[' derailed rifle industry� stay,ISE rightfill barrels in procedure backed international']	["65°68'N, Kangerdluarsikajik"]
['j interest the industry,kie']	['17.8.1899']
[' advocate =ages of greatly']	['Natural History Museum of Denmark']
[' Payment EXP00']	['Herbarium C']
[' counter United the governed extends kings aboveidge']	['Image No. NHMD-694150']
[' Len pressing emphasizing 24ING seeds think']	['Plantae groenlandicae']
[" a unab've displayinginernd Pittsburgh sidelined from pressing the"]	['a Museo botanico Hauniensi distributae.']
[' repository dumps49- PDT 24ING preceding tree bleak " crashed the']	['Expeditio Danica in Groenlandiam orientalem 1898-99.']
[' Messiah PHOTO Nur83� Trust today 24']	['Lycopodium annotinum']
['ar Labor Judith in todaynam Public the']	['B pungens (some word)']
[' Pack the00 thearel over shots theoux remains instead PetrUniversity in taught Rap procedure Enterprises the']	['Leg. C. Kruuse. ad Kangerdluarsikajik']
[' Figures rifle techniques�U']	["65°68'N"]
['ah routekie']	['17 Aug 1899']
[' missing And devastatingens Ox Jets']	['Aira subspicata']
['-key Sharma a demolition humanityrer in result Hasan from']	['in locis apricis sinus Kangerd']
['ans levels readers international not MGM remains learningComment:// $ commissioner youroned']	['luarsuk (Kobbefiorden) 1830 Juli']
[' navyEEFit Estate incredible retains NHages, resultoux defendants ow former the']	['Universitetets Botaniske Museum, København.']
['ages displaying projectEXT Pittsburgh sidelined Dund the']	['Museum botanicum Hauniense.']
[' incredible retains foster drop blood shots Mitt Romeo " marketsBUG formerINGrying the']	['Botanisk Rejse til Vest-Grønland 1932.']
[' Share Our Sh pride not any Murray the $U remains fairness the']	['Phippsia algida (Sol.) RBr.']
[' Organization in Wing offseason Du from, Organization international character468 do, Chí Public ensure Oklahoma the']	['Disko: Kuanit, Diskofjord, i Elvleje.']
[' interest statement the systemeport']	['No  6/VIII.  leg. et det. Johs. Grøntved.']
[' resultoux remains yourread multiple And Nurs not You attackers the $ating GIF the']	['Kobresia bellardii (All.) Degl.']
[' tonight minor response in bowling sailors Sh k rifle challenge�']	["Atanaitsunguaq 70°22'"]
[' lot fr actors sells last India backyard logical do']	['4-8-1921 A E Porsild']
[' gene from, cure Dar evenoux your rent']	['Herb. Joh.Lange']
[' outcome And Your statement cultural attackers']	['Poa glauca Vahl']
[' Ryan Petr Wash believes afflicted think the']	['B. elatior Lge.']
[' excuseinf peeled Falcons do railwayPick docom Ch once terrorfill468 walk shots']	['Sermilik (Bredefjord) i Tunudliorfil']
[' once slam proposed loser Euras not previous468 Results name $']	['Fjord. 28 Juli 1876 (Kornerup)']
[' psychic Sweden83athuledowski believes']	['Trisetum sūbspicaticūm P.A.Sórensen Jakobshavn 4/8 1892']
[' driven Bas-. PR seems WrightSW not underking 1950 sixty Andcom']	['Revisionary Studies in the Genus WOODSIA (Aspidiaceae)']
[' Johnson the even adapting JustU the Improvement']	['W. glabella R.Brown']
[' expensive thetering']	['Sept. 1956']
['ant someone the official the regular, services ofally the']	['Donald F. M. Brown, University of Michigan.']
[' Len pressing emphasizing 24ING seeds think']	['Plantae groenlandicae']
[" a unab've displayinginernd Pittsburgh sidelined from pressing the"]	['a Museo botanico Hauniensi distributae.']
[' Wright Share expert adapting JustU the looking statement the']	['Woodsia glabella R. Br.']
[' If from the Camco the 2012ps the']	['Det. Joh. Lge.']
[' happy Rap runtime mostly rifleait� 2007 the!, the']	["Kingarsuak 70°43' n.Br."]
[' must the route the exhaustive herterror fromat the skeptical']	['7. aug. 1888 legit S. Hansen']
['!), lush 78 contractor ETiger medal not officers tragedyco the $']	['Calamagrostis neglecta (Ehrh.)']
[' If described the clouds Public theat468 24 shareholders']	['determ. Thorv. Sørensen 1954']
['!), over rents ET LO today']	['Calamagr. neglecta']
[' predicts If described the00 the via the Comfortleness the']	['1926 determ. C. H. Ostendeld.']
[' exception crafts reduced apart contractor reduced en the']	['DEN DANSKE ARKTISKE STATION.']
[' ignores Sci, drainage stay dan the']	['DISKO, GRØNLAND.']
['!), lush 78 contractorfaceningcks']	['Calamagrostis Lyperborea']
[' displeasure']	['Lange']
[' Sour " marketsBUG layoffs thepm scope inread join Water, that server tattoo " treatmentPick do,we rifle belief� interest the']	["Syd-Grønl. Qagssiarssuk, Igaliko-Fjord, 60° 53' N."]
[' State the route the vis the']	['5. Aug. 1925.']
[' last the officers the la rights logical do children official the la the backyard logical do the']	['A. E. Porsild & M. P. Porsild.']
['ages displaying projectEXT']	['MUSEUM BOTANICUM']
[' flowing Hom made the']	['HAUNIENSE.']
[' Catholic comparede swast mism And the prior the']	['Carex ampullacea. Good.']
[' than PDT 24ING Ann would inequality undidy MackFel in Bradley rifle They�']	["In Groenlandiæ meridionalis sinibus 67° 2'."]
[' teams the cultural attackers the']	['J.Vahl.']
['iana markets artistic the']	['FORGIFTET.']
[' emergencies a Stuff83']	['radices alpium']
['rer in� inceiveakura the']	['sinus Tasermiut.']
[' owners Sh the that the cultural attackers the route the']	['Leg. J. Vahl 1829. Aug.']
['ages of. services, withstand']	['Botanic Museum of the University, Copenhagen']
[' prote646']	['Greenland Plants']
[' asorts 24 Go Decemberncomic to rest prote adequately Nouc the']	['The triennial Danish Expedition to East Greenland 1931 - 34.']
[' United State the Ez Bears Given in nightmares Andior remains the']	['No 5373. Luzula confusa Lindeb.']
[' thatara premiere rifleep� instead']	["Lat 71°35'N"]
['27 the challenge rifle black� Johnson the']	["Long. 22°25'N"]
[' explored the']	['Alt.']
[' that commit the� Mad also as Sto international readers seemsamus']	['Loc. Canning Land: The Isthmus between']
['ANDikk oncePick do would do instead way international Brady from oncePick from the']	['Carlsbay Fjord and Nathorst Fjord.']
[' recipes also research the result statement Either']	['Date: 30. VII 1934']
[' haven the clouds Public theat468 24 shareholders']	['Leg. THORV. SØRENSEN']
[' Flag the interest statement the']	['Det. Th. S.']
[' outcome AndOCK do from Petr14 sustainable Federal right racing shareholders']	['Poa pratensis macrorrhiza']
[' Ch tree ©']	['ianisia']
['']	['Wahl']
['-t Sal� from Iter souls seemsrer in']	['in locis fertilioribus sinus']
[' policy Typically from zombie route']	['Amaralik 1830 aug.']
[' Russia the Last your in']	['P. pratensis']
[' outcome And suit Midlands photo Pleaseieve small Minnesota Jets looking She international from']	['Poa flexuosa var. elongata Alyth']
[' teams the 2012 the']	['J.L.']
[' Euras']	['1876']
[' underonga83 uprisingville Cou And not scope $ someone Public $']	['Aspidium Filix mas (L. / Sw)']
[' rendering doBUG formerING, outcome regulations spray Water organic rifle Lions� by']	["Sydgrönland, Paniagaluk 59° 55'."]
[' suicides small Canada handingstrom in Scarborough the']	['1891 Eleonora Lundholm.']
[' navyEEFit Estate displayinginer NHages, resultoux defendants ow former the']	['Universitetets botaniske Museum, København.']
['ages displaying projectEXT Pittsburgh sidelined Dund the']	['Museum botanicum Hauniense.']
[' publisher646']	['Arctic Plants']
[' navyEE Bruce contractorSher dedicated think displaying project seeds think suggested firms Forward, Seeking engine']	['UNIVERSITATIS CAROLINAE BOTANICAE CATHEDRA, PRAGA']
[' Make And Your And cultural attackers']	['Poa glauca Vahl']
[' Osh methods realm Remember']	['29. 11. 1963']
[' outcome And ET heckville They the']	['Poa nemoralis L.']
['ieve Changes crown the']	['var. glauca']
[' 2012oux remains reaching195 in IO Just levels']	['Lichtenfels Gronland']
[' the Stoke remains kindergarten Sh']	['Mission. Tietzen']
['IRT']	['1853']
[' Len pressing emphasizing 24ING seeds think']	['Plantae groenlandicae']
[" a unab've displayinginernd Pittsburgh sidelined from pressing the"]	['a Museo botanico Hauniensi distributae.']
[' repository dumps49- PDT 24ING preceding treelanders No Reid Indiaar']	['Expeditio Danica in Groenlandiam orientalem 1901-2. E3']
[' Pars And lawful,." overap inflationoeuv shareholders']	['Chamaenerion latifolium']
[' not confirmed $PT Financial']	['(L) Spach']
[' Pack the delivered thearel Economic a do the happy And Dupart seemingly rifle F�']	["Leg. C. Kruuse ad. Kingarsuak 66°10'"]
[' challengeaying). streamed']	['22 juni 1902']
[' pool serious the Len pressing emphasizing 24ING seeds think']	['367. Plantae groenlandicae']
[" a unab've displayinginernd Pittsburgh sidelined from pressing the"]	['a Museo botanico Hauniensi distributae.']
[' outcome And Our href 2012 the']	['Poa alpina L.']
[' that If from- do your aens 64 reaching the teams the that Sh do Gain "']	['I det indoe af Dalen Ø.f. Igdlor-']
['rules from the']	['pait']
[' emphasizing 24 main the overlooking the government 134, official the baby the Oxford in easier the']	['GROENL. OCCIDENT.; Disco, N.V. Kysten.']
[' Navy resulted streamed theat468 24 Russia the backyard logical do the']	['26. 7. 1902 leg. Morten P. Porsild.']
[' exception crafts reduced apart contractor reduced en the']	['DEN DANSKE ARKTISKE STATION.']
[' ignores Sci the drainage stay dan the']	['DISKO. GRØNLAND.']
[' Catholic compared LX in from trash']	['Carex holostoma']
[' Falcons featuresiated from interest the teams the sentimental in ow former']	['Brede Bugt n. f. Jakobshavn']
[' Master rifleate�']	["69° 18'"]
[' system brewEm']	['6/8 1915']
[' haven the Russia the backyard logical do the']	['leg. Morten P. Porsild.']
[' Payment EXP Juice). displaying project Anaheim Pittsburgh sidelinedeve the']	['Herbarium musei botanici Hauniensis.']
['aying bankruptcy type Du Kingsocated the']	['Juncus castaneus Sm.']
[' Lov PDT overING Truman not anyVD in ow former $']	['NordGronland 1867 (Jakobshavn)']
['U the official468 24 not q doher CW inquin right the $']	['R. Brown (Whymper Exped.)']
[' navyEEFit Estate displayinginer NHages, resultoux defendants ow former the']	['Universitetets botaniske Museum, København.']
['ages displaying projectEXT Pittsburgh sidelined Dund the']	['Museum botanicum Hauniense.']
[' publisher646']	['Arctic Plants']
[' Care (. candle Controller 1987 idiosyncr No Cous the']	['collected by the MORAVIAN BRETHREN 1847 - 1856.']
[' notSTON official the Russia backyard logical do also exam K Krypt in to. hasht of joined "']	['(See M. P Porsild: Stray Contributions to the Flora of Green-']
[' shows Illuminati the week Poor do the TalksayBUG former main the looking do the Ja, United theig therap sq, 18 thecht "CLASS']	['land XII. - Medd. om Grønl. Bd. 93, No. 3 (1935), p. 84-94)']
[' missing And Our href 2012 the']	['Aira alpina L.']
[' thereforevironments former needless in-ayBUG formerING']	['Lichtenfels in Gronland']
[' by target trouble in� former ifat Petr from cafe']	['Mifsiona Tietzen']
['IRT']	['1853']
[' campaign Petr Thomas Our href 2012 the']	['Aira alpina L.']
[' lin fromhew195 in milestonepmbling JustIM']	['Lichtenfels in Gronland']
[' reminds statement shareholders convincing remains kindergarten Sh']	['Mifsiona Tietzen']
['IRT her']	['1853']
[' navyEEFit Estate displayinginer NHages, resultoux defendants ow former the']	['Universitetets botaniske Museum, København.']
['ages displaying projectEXT Pittsburgh sidelined Dund the']	['Museum botanicum Hauniense.']
[' Len pressing PDT 24ING seeds think the']	['Plantae Groenlandicae.']
[' Catholic compared defunct discouraged thread the']	['Carex nardina Fr.']
[' If from the00 from the movie the']	['det. etto.']
[' interest the baby theayBUG formerING,phyhewlah inat468 24 shareholders,']	['N.V.Gronland, Wolstenholme Sound,']
[' sent right result main the know Jesse Whatever']	['Saunders Isl.: Agpat']
[' National must the Fighting']	['12.7.1911']
[' that commit planned psychic Mt']	['leg. Peter Freuchen']
[' borders Adv49 also detriment). thous 253']	['Familie: Saxifragaceae']
[' skills foster former also resultSat her pus remainstainment']	['Dansk navn: Knoje - Stenbræk']
[' Areasn foster former also detriment). thous Androwing former nutrition']	['Latinsk navn: Saxifraga cernua']
[' Roof also teams468 volunteers lookingBUG former aided someone blood the AE ShING']	['Lokalitet: Jòrgen Brònlund Fj. Pearyland']
[' concealed Grace Luis pride do in not in Senate from $ also psychic the timing indaq the tendaded internationalBUGpsoned']	['Vokseplads (samf.): Fu. Ruos r. Keddelkrogelr']
[' 64 China also lot her must another right also']	['Dato: 4-7 Findere: Jean Just']
[' seemingly']	['66']
[' that the V the la the']	['I.C.P.']
[' tackles rifle F� interest research rifle research� Johnson']	["82°10'N 30°30'W"]
[' hasht PDT 24ING seeds the']	['Flora Groenlandica.']
[' Cafe typical Sha Thomas 2012 the']	['Festuca rubra L.']
[' ch remains468rd way shut campaigngoers doisers rights do your from teams metrics project ArenaSharesfecturedaily from']	['Overburestedet Itivdliarssuk Julianehaabs Distrikt']
['j decorations histories her']	['13/7 1897.']
[' haven the coc partly Cups the']	['leg. Gustav Meldorf..']
[' exception crafts reduced apart contractor reduced en the']	['DEN DANSKE ARKTISKE STATION']
[' ignores Sci, drainage stay dan the']	['DISKO, GRØNLAND.']
[' rarely YuICA operating']	['Pucc. Vaginata']
[' If from asat intenseinter']	['det Th S 1949']
[' Romeo " marketsBUG former main thepm acquiredpadding roster international someonePick do the FISA Dublin premiere rifle must interest the']	["Vest-Grønl. Qaumarujuk Fjord, Qingua, 71° 7' N."]
[' injunction loser). batters,']	['27. Juli 1935,']
[' official the Russia the backyard logical do the']	['M. P. Porsild.']
[' exception crafts reduced apart contractor reduced en the']	['DEN DANSKE ARKTISKE STATION']
[' ignores Sci the drainage stay dan the']	['DISKO, GRØNLAND.']
[' presents components Your And 2012 the']	['Salix glauca L']
['ayReader Georgian the furtherevin face the Nam the interest skipped Bradley rifle memory� thatara the Elsa the']	["GROENL. OCCID. ca. Neria 61° 33' lat. bor."]
[' National must intense Australia']	['12/7 1924']
[' haven the teams the compassion volunteers throws the']	['leg. J.Eugenius.']
['oul Sweden ideasorts ideas not V Solid main the $ 2012 blew This children 2012oux This']	['Trisetum triflorum (Bigel.) Löve & Löve']
[' National the composer realm integrity']	['12.11.1979']
[' Flag the Oregon discovers Guru']	['Det. Jon Feilberg']
[' missing And devastating in Ox Jets']	['Aira Subspicata']
['- limit Petr in today a demolitionvilleagan over askingco']	['in locis apricis Nennese']
[' loser). the']	['1829 Juli.']
[' skills foster Quick partial peeled fiscal inoux mund shots aensayBUG formerING bleak']	['Dansk geologisk Undersøgelse af Grønland 1878']
[' blessed Bears Android funding 2012 the']	['Betula nana L.']
['year Marathon). Grid Labor And interest today formations aens Processor right Tal']	['Utilivik paa Nordsiden af Fiskernæs-']
[' someonePick easier']	['Fjorden.']
[' Stateaying the']	['5 Jun.']
[' last theDOWN right name the']	['A. Kornerup.']
[' Facebook the he from Residents']	['d. arctica']
[' 2012 theAkco']	['L. Koch']
[' schools decorations spinal']	['21/7.16']
[' navyEEFit Estate displayinginer NHages, resultoux defendants ow former the']	['Universitetets botaniske Museum, København.']
['ages displaying projectEXT Pittsburgh sidelined Dund the']	['Museum botanicum Hauniense.']
[' Len pressing PDT 24ING seeds think the']	['Plantae Groenlandicae.']
['26 from Senaterob AndMan racing shareholders not any Russia the Klein the $']	['Deschampsia caespitosa (L) P. Beauv.']
[' Har way a comparedPlay not fourthval the $ diamond over the']	['var. arctica (Tsin.) Simu.']
[' official the Johnson the Drag over main the,phyhew are trackedat468 bankruptcy the']	['NW Greenl., Walstenkoline Sound:']
['year USE113,ie product 8 gets']	['Umanaq, old dry skingle']
[' Har way']	['bed.']
[' schools the $lessness the']	['21.7.1916.']
[' haven the']	['leg.']
[' displeasure commuting the']	['Lange Koch']
[' capitalist even She shrugged from in right asking']	['Equisetum sylvaticum']
[' even']	['Linné']
['- to Sharmavar remainsark in dramatic a do emergencies from']	['in locis subhumidis ad radices']
[' Our Girls over suit468 Kings scales debut racing']	['alpium sinus Amaralik']
[' Ez the someone the cultural attackers the']	['Leg. J.Vahl']
[' spherical loser).']	['1831 Juli']
[' Len pressing emphasizing 24ING seeds think']	['Plantae groenlandicae']
[" a unab've displayinginernd Pittsburgh sidelined from pressing the"]	['a Museo botanico Hauniensi distributae.']
[' repository dumps49- PDT 24ING preceding treelanders No Reid']	['Expeditio Danica in Groenlandiam orientalem 1901-2.']
[' Indiaig']	['E3']
[' Pars And lawful49 bankruptcy limit Petr from inoeuv ideas']	['Chamaenerium latifolium']
['ensive conform Petr Financial the']	['(L.) Spach.']
[' suit the Ryansun And shadeshood']	['f. stenopetala']
[' owners blood the00 thearel Economic a do the Sar over medal trends Download�']	["Leg. C. Kruuse ad. Tunak 65°55'"]
[' system route streamed']	['6 Aug 1902']
[' navyEEFit Estate displayinginer NHages, resultoux defendants ow former the']	['Universitetets botaniske Museum, København.']
['ages displaying projectEXT Pittsburgh sidelined Dund the']	['Museum botanicum Hauniense.']
[' uniformspurpose contributing thrillingomic 24,oulder actorsVILLE theozyg']	['„Danmark" Expeditionen, 1906-1908. 237']
['Nothing in ( Bright in today 2012 the']	['Juncus biglumis L.']
[' her If from the00 the q the baby the']	['- det. etto.']
[' emphasizing in overING Share Elsa the " rights McCl the also result shut Har way Romeo right via statement the']	['Groenlandia bor.-orient.: Kæret ved Vester Elv']
["ah loser). her motiv limit Petr Sh the'statement the Scarborough rents the"]	['17 Juli 1907 leg. Andr. Lundager.']
['ages displaying projectEXT']	['MUSEUM BOTANICUM']
[' flowing Hom made the']	['HAUNIENSE.']
[' Catholic compared 201Radio sixty prior theiana markets artistic']	['Carex ampullacea. Good. FORGIFTET.']
['-anned Goldmanrob in aens']	['In paludosis ad']
[' emergencies Our Ox ideas']	['nadices alpium']
['rer in that server tattoo']	['sinus Igaliko.']
[' 2012 Petr Sh theuck baby Panzer the the route the']	['Leg. J. Vahl 1828. Aug.']
[' navyEEFit Estate displayinginer NHages, resultoux defendants ow former the']	['Universitetets botaniske Museum, København.']
['ages displaying projectEXT Pittsburgh sidelined Dund the']	['Museum botanicum Hauniense.']
[' Muhammad Oy Sr over inomic 24 Lov TalksayBUG formerING journalism actors whereas the']	['Jubilæums Expeditionen Nord om Grønland 1920-1923.']
[' Russiameter creativity 900 Columbia Sentinelibur in not fourthval $year easier racing over the']	['Puccinellia phryganodes (Trin.) Scribn.']
["aw the't former the"]	['& Merr.']
[' interest the Johnson the PDT 24ING also sold in from insight Mad, Russia IoT right over foster']	['N.W. Greenland: Washington Land, Pustersnack']
[' interest the Areas the also delivered the weight rifle,']	['N. Lat.: e.80°,']
[' displeasure commuting']	['Lauge Koch']
['ah brew gallon the']	['13/8 1921.']
[' haven the teams thechanging Tah sensing']	['leg. [J. Noe Nygaard.]']
[' If described the00 the via the Comfortleness the']	['determ. C. H. Ostensfeld.']
['ages of. services, withstand']	['Botanic Museum of the University, Copenhagen']
[' prote646']	['Greenland Plants']
[' asorts 24 Go Decemberncomic to rest prote adequately weekuc the']	['The triennial Danish Expedition to East Greenland 1931 - 34.']
[' United Lions result statement theAK consensus Whatever:// 24 18 She in from in Petr from parks 24 suit the']	['No 55 12. Eriophorum polystachyum L.']
['ieve Crimean over113 checks result statement the']	['var. tristis Th Fr.']
[' Areas thrilled rifle populated� Public']	["Lat 74° 06'N"]
['27 the that international k even']	["Long. 21°20'W"]
[' explored the Figures Federal the']	['Alt. 75 m.']
[' via statement the Wol This Southeast teams walk also interest the Scott the teams theAKco shareholders shareholders in']	['Loc. Clavering Isl: N.W. of Eskimonæs']
[' recipes also k the subscriber made result Transport']	['Date: 20.VII 1935']
[' haven the clouds Public theat468 24 shareholders']	['Leg. THORV. SØRENSEN']
[' Flag theDC the State man']	['Det. Th S/.']
[" season liking fair.'':// Toronto115"]	['S. flagellaris Willd']
[' Ryanuled theshots K shotsigraph not TessInoned the $ backyard in "']	['ssp. platysepala (Trautv.) Pors.']
['ating described the alsowellEle from Assistance theGP']	['Determ.: Eric Hultén. 1963']
[' Manchester Steve Onlyating cr in knowing Lov Conway "olerance nucleus PVC Atlas the']	['Zweite Deutsche Nordpol-Expedition 1869-70.']
['omic in kmowers uniforms Cros Share 2018']	['Expeditionsschiff,,Germania."']
[' detriment). scouts the artists typical Investigatorsmer do']	['Saxifr. Flagellaris Willd']
[' further in in fromEverybody todayayBUG formerING also ✔ than gunshot,ay Gain phrase than in Petr main "']	['Oestliches Grönland: Sabine-Insel, [Clavering Insel.]']
['iana markets artistic the']	['FORGIFTET.']
[' Len pressing emphasizing 24ING seeds think']	['Plantae groenlandicae']
[" a unab've displayinginernd Pittsburgh sidelined from pressing the"]	['a Museo botanico Hauniensi distributae.']
[' repository dumps49- PDT 24ING preceding treelanders " Reid Indiaar']	['Expeditio Danica in Groenlandiam orientalem 1901-2. E3']
[' Pars AndJV think limit Petr Stuff inflation installment']	['Chamaenerion latifolium']
[' by schoolsat blood Petr medal']	['(L) Spoch']
[' haven the00 thearel over shots a do theCAN in Petr shareholders in Petr international seemingly rifle State�']	["Leg. C. Kruuse ad. Ikerasausak. 66° 5'"]
[' researchaying). streamed']	['30 Juni 1902']
[' navyEEFit Estate displayinginer NHages, resultoux defendants ow former the']	['Universitetets botaniske Museum, København.']
['ages displaying projectEXT Pittsburgh sidelined Dund the']	['Museum botanicum Hauniense.']
[' Len pressing PDT 24ING seeds think the']	['Plantae Groenlandicae.']
[' shields former Just Given nightmares And']	['Luzula confusa']
[' Flag the last the baby the']	['det. ett. o.']
[' instead theayBUG join from 50, Drag This move Har way Har way']	["V. Grónland, Giesecke's Sø ved"]
[' spine asking campaign468 namePick do nother do impulse113 think Falcons Public $']	['Nordre Strømfjord (sydvestlige Bred).']
[' West fr actors methodsire blood instead the United do operate Kear']	['11-8-1911 leg. V. Nadmann']
[' navyEEFit Estate displayinginer NHages, resultoux defendants ow former the']	['Universitetets botaniske Museum, København.']
['ages displaying projectEXT Pittsburgh sidelined Dund the']	['Museum botanicum Hauniense.']
[' Len pressing PDT 24ING seeds think the']	['Plantae Groenlandicae.']
[' Catholic compared850Ilán inAfter the']	['Carex rupestris All.']
[' letters metrics Public Petr14 herphyhew reduced regionalat468 24 shareholders also']	['N.W. Greenl. Wolstenholme Sound:']
['year men scope the']	['Umanaq.']
[' Guardian thelessness']	['7.8.1916 leg. Lange Koch.']
[' cynical hus83apOX ideas hitch foster former the']	['Epilobium lactiflorum Hausskn.']
[' Flag right over aggress do (, planned00 therots French']	['Determined by Peter C. Hoch']
[' hill consensus adoptiondescription Telulu']	['Missouri Botanical Garden 1977']
[' Ambassador Ryan the']	['831.']
[' cynical hus83 showing468 Results in Hydro']	['Epilobium Hornemanni']
[' suit Ernst statementarma seeds110 shareholders the']	['f. Lubradorica Hausskn.']
[' Organization Officer, bicycle suitPick do,DOWN Chevron features from']	['Disko, Mellemfjord, Kvindstedet']
[' National the industry the streamed the']	['12.8.1902']
[' official the interest the backyard in response do the']	['MP. Porsild.']
[' United Westific']	['Nr.11100']
[' black']	['25']
[' term Sub in870 Kings']	['Alopecurus']
[' a Stuff survival Tal']	['alpinus']
['apolis aens resultoux remains tickets And And']	['Eng v/ Kobberaa']
[' titled over ensure']	['Thule']
[' her research decorations proper']	['30/7 39']
[' afflicted the cloudsblers installment']	['leg. Thorlaksson']
[' transgender crafts reduced Loan ensure "yes im Adventure Madinkleuled nucleus']	['Den danske Thule-Ellesmere Land Ekspedition']
['ages of. services, withstand']	['Botanic Museum of the University, Copenhagen']
['646 of Criminal prote']	['Plants of Northwest Greenland']
[' difficult.nc Loan ensure "yes im Adventure Mad Bucks']	['From the Danish Thule-Ellesmere Land expedition']
[' pitchers tighten the']	['1939-40.']
['kan Volks from00 the Hall']	['PRIKKET C. BAY']
[' lastricting Nu seems a Stuff polymerocated the']	['Alopecurus alpinus Sm.']
['apolis the']	['Eng.']
[' explored the']	['Alt.']
[' performing areas the result NHS exp boundary,']	['Loc. Kobberå, Dundas']
[' delivered the checks rifleuc rifle interest the techniques rifle knee rifle Johnson the']	["c. 76°34' N. 68°48' W."]
[' recipes also recognition serious clandestine United the Westonson']	['Date. 30.7.39 No. 11125']
[' haven theay the clouds main boundary Grace Brown']	['Leg. G. Thorláksson']
[' Flag the result the sentimental shareholders']	['Det. K. Jakobsen']
[' react And ET heckville']	['Poa nemoralis']
['ay the Johnson theat468 24 shareholders']	['P.H. Sorensen']
[' India costume today over aggress loser). disproportionate the']	['Egedesminde Juli 1894']
[' cynical hus83 effectivenessaptopried memor 24 remains the']	['Epilobium hornemannii Reichenb.']
['athuled the effectivenessaptopried']	['subsp. hornemannii']
[' Flag right over aggressher planned00 therots']	['Determined by Peter C. Hoch']
[' hill in int).description adventures']	['Missouri Botanical Garden']
[' tuition']	['1978']
[' exception crafts reduced apart contractor reduced en the']	['DEN DANSKE ARKTISKE STATION.']
[' ignores Sci the drainage stay dan the']	['DISKO. GRØNLAND.']
[' cynical hus83PK over sooner']	['Epilobium hornemannii']
[' asked ow former']	['Godhavn']
[" deliveredput've,osc industry realm occur"]	['Disko, 24.8.1912']
[' haven the clouds remains instit backyard logical do the']	['leg. Thorbjørn Porsild.']
[' exception crafts reduced apart contractor reduced en the']	['DEN DANSKE ARKTISKE STATION.']
[' ignores Sci, drainage stay dan the']	['DISKO. GRØNLAND.']
[' Meter typical Europeans Please grantsville']	['Capsella bursa pastoris (L.)']
[' would do the']	['med.']
[' Sour " marketsBUGarts the hackers in in deliberate,PORT ace do Comments fingertips racing " treatmentPick do,we rifle Lions� interest the']	["Syd-Grønl. Narssaq, Tunugdliarfik-Fjord, 60° 55' N."]
[' industry the route the vis the']	['8. Aug. 1925.']
[' last the India the backyard logical do children official the la the la rights logical do the']	['A. E. Porsild & M. P. Porsild.']
['ages displaying projectEXT']	['MUSEUM BOTANICUM']
[' flowing Hom made the']	['HAUNIENSE.']
[' limit right Xiaomi And prior 24 the']	['Carex rigida Gooden.']
[' Value And Cole im economy cocktail the']	['saxatilis Drej.']
['iana markets artistic the']	['FORGIFTET.']
[' haven the that the cultural attackers Berserker the route the']	['Leg. J.Vahl 1834. Aug.']
[' a doas And- Galaxy district']	['ad later inferio']
[' policing Our mid83 showing468 Con']	['ra alpinum Terri']
[' to Mumbai Ryan Petr abilityyear union Go the']	['Torii colon. Uperni']
[' Berkeley international her']	['vik -']
[' skills foster Quick partial peeledFX assembled foster fiscal inoux mund shots']	['Dansk geologisk og geografisk Undersøgelse']
[' aensayBUG formerING Mikhail']	['af Grønland 1885.']
['str Oklahoma Sub your do83� right D83 suit,Man main Memorialco your']	['Lycopodium annotinum ß. alpestre']
[' system very Sh the']	['Wg.']
[' instead theayBUG Public main the result hunt Sh Water, across today']	['V. Gronl. Kunguk. ca 65°']
['ar loser the']	['3 Jun']
['str theat the skeptical']	['by. S. Hansen']
['protect of Ell desktop']	['FLORA OF THULE']
[' mother of bankingments']	['REGION OF ETAH']
[' United the Ambassador']	['No. 83']
[' Make And evenRec fencing opinion do the']	['Poa glauca Vahl.']
[' turnout disappears,"). Financial the']	['Rocky delta, Etah.']
[' route the indeedEm the']	['aug. 13, 1915.']
[' Johnson theí ANDinkle remainsurs']	['W. ELMER EKBLAW']
[' stereotypical SuchINGomic']	['CROCKERLAND EXPEDITION']
[' Areas paving featuresate rifle k� interest']	["Latitude 78°20' N"]
[' that though Sh paving featuresFX They rifle research� Johnson']	['Longitude 72°30 N']
[' navyEEFit Estate displayinginer NHages, resultoux defendants ow former the']	['Universitetets botaniske Museum, København.']
['ages displaying projectEXT Pittsburgh sidelined Dund the']	['Museum botanicum Hauniense.']
[' Len pressing PDT 24ING seeds think the']	['Plantae Groenlandicae. 1495']
[' Catholic from policing herd prim And not Scott Sh $ throughout']	['Carex rariflora (Wg) Smith']
['ans Grace railwayPick do strategy brew Fighting']	['Laksefjord 26/8 1911']
["'statement the Scarborough rents"]	['leg. Andr. Lundager']
[' last� 222 throbReader']	['ALFRED BENZON']
[' via the someone the Kos the']	['Yl. Fe. vi.']
['Cell rescued herj her']	['J22-1']
[' underking way the substance donations contractor the']	['Aspid. Lonchitis']
[' asked ow former the grunt, Master rifle']	['Godhavn. Disco. 69°.']
[' Truman theproof Bruce crying relative']	['1864. Tabita Broberg']
[' result Not further looking India interest via Pu former the']	['KJÖBENHAVN.']
[' Beer navyEEFit Estate incredible retains NHages, resultoux defendants ow former the']	['Fra Universitetets Botaniske Museum, København.']
[" India unab've've Pittsburgh sidelined Dund the"]	['E Museo Botanico Hauniense.']
['descriptionses- 100 " renovationsINGrying the']	['Botanical Investigations in West-Greenland 1932.']
[' India bail inanshen href Johnsoncoher the']	['Carex lagopina Whbg.']
[' Organization from usage also call Power,sat Beckham indicated international']	['Disko: South coast, at Sinigfik']
[' Nam thearades the: evenhewire Andacularoux your']	['ca. 3 km from the sea shore.']
[' United k Sh Australia veryishes the']	['No 207 24/VI.']
[' haven the banking If from the Camco in theayBUGarts This do the']	['leg. et det. Johs Grøntved.']
[' navyEEFit Estate displayinginer NHages, resultoux remains Assistance ow former the']	['Universitetets botaniske Museum, København.']
['ages displaying projectEXT Pittsburgh sidelined Dund the']	['Museum botanicum Hauniense.']
[' publisher646']	['Arctic Plants']
[' Care (. candle Controller 1987 idiosyncr No Cous the']	['collected by the MORAVIAN BRETHREN 1847 - 1856.']
[' notSTON official the Russia backyard logical do also exam K Krypt in to. hasht of joined "']	['(See M. P Porsild: Stray Contributions to the Flora of Green-']
[' shows Illuminati the week Poor do the TalksayBUG former main the looking do the Ja, United thear therap sq, 18 thecht "CLASS']	['land XII. - Medd. om Grønl. Bd. 93, No. 3 (1935), p. 84-94)']
[' Make And Our href 2012 the']	['Poa alpina L.']
[' 2012oux remains reaching195 in APayBUG formerING']	['Lichtenfels in Gronland']
[' official trouble in the Public former the Sar Hungry']	['Mission Tietzen']
['IRT']	['1853']
[' advocate =ages of greatly']	['Natural History Museum of Denmark']
[' Payment EXP00']	['Herbarium C']
[' counter United the governed extends " satellite Dar sparked']	['Image No. NHMD-811868']
['iana markets artistic the']	['FORGIFTET.']
['Former throb screen Agreement']	['ALFRED BENZON']
[' via the� the instead statement the knee any the baby the']	['ye. fe. vi. 483. of.']
[' They the Falcons Public inando Comments from']	['5 Brevifolia']
[' Russiard tweeting He 2012']	['Festuca ovina L']
[' asked ow formerat468 24']	['Godhavn Disco']
[' Master rifle interest the instead the']	['69° N. Ø.']
['owment Minority Bruce crying bowl']	['1864 Tabita Broberg']
[' result Notoux are former the']	['KJÖBENHAVN.']
[' is anyens the']	['! SF']
[' Cafe fencing Huawei unlimitedSpeaking Justhaired slated']	['Festuca brachyphylla Schultes W.5']
['ief features from the result tantal do Huang 24']	['1962 det. Kjeld Holmen']
[' Cafesystem merch This official the Facebook areas the']	['Festuca brevifolia\xa0R.Br.']
[' for Canada Loc main theules the']	['! Schol. 1933.']
[' well January Payment EXP not drawn $']	['US NATIONAL HERBARIUM (US)']
[' Make And imperIn nutrition Ryanuled theockey acquired Comments think 2012 the teams the']	['Poa flexuosa ssp. consauliae L. J.']
['uls todaytimes children MIT stupid']	['Gillespie & Soreng']
[' cases Russia the evenRec fencing cultural attackers']	['toward P. glauca Vahl']
[' Flag the alsoU the teams the MIT stupid, earlier']	['Det.: R. J. Soreng, 2017']
[' Payment EXP last conferences,description,, services of last levels escal']	['Herbarium AAU, Botanical Institute, University of Aarhus']
[' United the']	['No.']
[' interim And Lincoln Italian Anday over the']	['Poa flexuosa Gn']
[' Department LarsFXden confirmedoux sensing']	['6/1989 Simon Lægaard']
[' backyard evenRec fencing']	['Poa glauca']
['at468 24 shareholders clouds Public the." constant shareholders pushing Russia the separating Koch Santos from']	['Serv Thorv. Sørensen det. J. Naunfeldt']
[' Sund']	['1953']
[' skills foster Quick partial peeledFX assembled foster fiscal inoux mund shots']	['Dansk geologisk og geografisk Undersøgelse']
[' aensayBUG formerING the']	['af Grønland.']
[' Make And knackn in Concepts 2012ps the']	['Poa laxiuscula Lge.']
[' instead theayBUG formercs also Rhodeamed in Dip']	['V. Grónland: Holsteinsborg']
[' system route the']	['6 Aug.']
['modern bowl Labor And Patriots treatment K Derby was inm across Sh fromudos aens']	["samlet paa „Fylla's” Togt 1884 af"]
[' whale the Mines ButFX TMZ the Huang the']	['Eug. Warming og Th. Holm.']
[' exception crafts reduced apart contractor reduced en the']	['DEN DANSKE ARKTISKE STATION.']
[' ignores Sci the drainage stay dan the']	['DISKO. GRØNLAND.']
[' Linkville he fo Kennedy notsan from in $After the']	['Arabis arenicola (Rich) Gel.']
['ayReader Georgian the furtherevin face the']	['GROENL. OCCID.']
[' offices rights indicated international, mostly rifle premium�']	["Patorfik, 70° 42'"]
[' injunction loser). gallon the']	['27. Juli 1921']
[' haven the last theAKick backyard logical do the']	['leg. A. Erling Porsild.']
[' skills foster Quick partial peeled fiscal inoux mund shots aensayBUG formerINGSTR,']	['Dansk geologisk Undersøgelse af Grønland 1879.']
[' lastricting Nu seems Our Girls seems forocated the']	['Alopecurus alpinus. Sm.']
[' result predict drinks indie, hanged Graphics aens interest the RussiaBUG overComment']	['Kekertarsuit, Mundingen af N. Strömfjord.']
[' State the loser). the']	['5. Juli.']
[' last theDOWN right name the']	['A. Kornerup.']
[' Len pressing emphasizing 24ING seeds think']	['Plantae groenlandicae']
[" a unab've displayinginernd Pittsburgh sidelined from pressing the"]	['a Museo botanico Hauniensi distributae.']
[' repository dumps49- PDT 24ING preceding tree suicidesCell Reid IND']	['Expeditio Danica in Groenlandiam orientalem [1891 92]. 1806']
[' performing doriahey aens in Sz criticisms international the']	['Cochlearia officinalis L.']
[' Ch 101 former." over." over expert Petr Wash from the']	['B groenlandica Gelert.']
[' 2012 Petr Sh interest therim conference a do Guinea Sylv over']	['Leg. N. Hartz ad Dunholm']
[' loser). incredible And']	['Juli 1806']
['ages of. services, withstand']	['Botanic Museum of the University, Copenhagen']
[' prote646']	['Greenland Plants']
[' United experimental Travis ensure ideas Our Girls ideas 2012 the']	['No 18.  Phleum alpinum L.']
[' Areas the ont levels Orlando indicated compared']	['Lat. Kuiartorfik']
['27 the']	['Long.']
[' explored the']	['Alt.']
[' performing areas the']	['Loc.']
[' recipes also National the subscriber made effic crashed the']	['Date: 12.VII.1899.']
[' Flag the Camco in the marketsBUGarts This do']	['Det. Johs.Gröntved']
[' haven the teams thecategory do commonly']	['Leg. J.Lindhard']
[' offseasonstones right chemistry international National decorations logo the']	['Kuiartorfik. 12/7/99.']
[' Russia shields former Our battles ideas not by']	['Phleum alpinum L.']
[' mirrors And sensing the']	['Lindhard.']
[' Catholic international trader in from Polly supremacyaw00 the Android goalieands in 2012 the']	['Care rostrata Stokes X C. saxatilis L.']
['Although, intense integrity']	['10.5.1979']
[' Flag the Oregon discovers Guru']	['Det. Jon Feilberg']
['ages of. services, withstand']	['Botanic Museum of the University, Copenhagen']
[' prote646']	['Greenland Plants']
[' Unitedured the lendmin trader facial operating supremacy']	['No 75. Craex rostrata Stokes']
[' Areas the']	['Lat.']
['27 the']	['Long.']
[' explored the Orioles think distribute']	['Alt.  Mose 13.']
[' performing areas the reacts throws in deliberate']	['Loc. Tasiussaq']
[' recipes also predicts the']	['Date:  1926.']
[' Flag the teams even rice in the marketsBUGarts This do']	['Det. Johs.Gröntved']
[' haven the result former the Not today shareholders']	['Leg. Kn.Jessen']
[' Len pressing emphasizing 24ING seeds think']	['Plantae groenlandicae']
[" a unab've displayinginernd Pittsburgh sidelined from pressing the"]	['a Museo botanico Hauniensi distributae.']
[' ChevroletSan shiny Finishedville 2012 the']	['Polypodium dryopteris L.']
[' PDT Anna� Jude the alsoincreasingakuraread international Chincreasinginch cr the']	['Groenl. austr.: Tasermiutsiak; Tasermiut.']
['425 interest therim conference� the pricey the StateOff the']	['logit N. Hartz an. 1889. 5/9.']
['ages displaying projectEXT Pittsburgh sidelined Dund the']	['Museum botanicum Hauniense.']
[' recognized asked 24 emotionalriedayThroughout negotiations Noahreport features where Public statement the']	['Carex goodenowii Gay x rigida Good.']
[' not V the marketsBUG overING from Nam the displeasure the $']	['(C. Groenlandica Lange.)']
[' aWithout over also00 the Comfort 24 Santos pricey the']	['determ: C.Ostenfeldt 1899.']
[' encouraged pilot statement the teams the Weekly walk, route the the']	['legit: J.Vahl, Aug. 1828.']
['year ShBUG attackers,-keyms in have former accordinglyville that server tattoo the']	['V Grönl: in locis humidis Igaliko.']
[' techniques rifle contributions� interest belief rifleonia� Johnson']	["68°46' N 53°07' W"]
[' Len pressing emphasizing 24ING seeds think']	['Plantae groenlandicae']
[" a unab've displayinginernd Pittsburgh sidelined from pressing the"]	['a Museo botanico Hauniensi distributae.']
[' Animated in contractor Sha Thomas "']	['agrostis rubra']
['ists* natural main the']	['occid.']
[' emphasizing 24 main thebytes the also']	['GROENL. [ORIEN]T.:']
[' ont Band k./ histories']	['Kullen 26/8. 1897']
[' Areas the Elsa thewe rifle2018�']	["Lat. Bor. 68°45'"]
[' haven the00 thearel Economic the']	['leg. C. Kruuse.']
[' Payment EXP Juice). displaying project Anaheim Pittsburgh sidelinedeve the']	['Herbarium muse botanici Hauniensis']
[' reimburse Sweden ideasirede midarians todayols And the']	['Equisetum scirpoides Michx.']
[' India blood Gooeuv ideas Wine Com in']	['equisetum reptans']
['ra in mainoux former Dip the']	['Holsteinborg.']
[' United remains do1960 the']	['Holboll 1844.']
['heny the Camco the confirmed Petr Owners']	['Herb. Job.Lange']
[' underonga83 2012oux201 desperately']	['Aspidium lonchitis']
[' AP bounce� in small amountedtwo inaledPosted spreading in']	['in locis irrigatis suboccuttis']
['rer inISE bullet Xander roster international not MGM LodComment the $']	['sinus Kangerdluarssuk (Kobbefjord.)']
[' zombie loser). the']	['1830 Juli.']
[' exciting right leaks optimized who DZero TMZ theat the']	['Hierochloe orthantha Th. S.']
[' If described the clouds Public theat468 24 shareholders deck trips chambers']	['determ. Thorv. Sørensen 1952']
[' navyEEFit Estate displayinginer NHages, resultoux defendants ow former the']	['Universitetets botaniske Museum, København.']
['ages displaying projectEXT Pittsburgh sidelined Dund the']	['Museum botanicum hauniense.']
[' publisher646']	['Arctic Plants']
[' Care (. candle Controller 1987 idiosyncr No Cous the']	['collected by the MORAVIAN BRETHREN 1847 - 1856.']
[' notSTON official the Russia backyard logical do also exam K Krypt in to. hasht of joined "']	['(See M. P Porsild: Stray Contributions to the Flora of Green-']
[' shows Illuminati the week Poor do the TalksayBUG former main the looking do the Ja, United thear therap sq, 18 thecht "CLASS']	['land XII. - Medd. om Gronl. Bd. 93, No. 3 (1935), p. 84-94)']
[' exciting right leaks code suspension Our href not pinned do the $ Jen difference childrenhaired slated']	['Hierochloë alpina (WILLD.) ROEMER & SCHULTES']
[' Ryanuled the who DZero not any468 24 shareholders $ay the could mix the']	['ssp. orthantha (SORENSEN) G. WEIM.']
[' Flag thehate could mix delete']	['Det. Gunnar Weimarck  1970']
[' could firepower medal,ay the unreal literal believes and viewing taxp of']	['WEIMARCK, G. 1971. Variation and Taxonomy of']
[' exciting right leaks code suspension not feminist Chi pressing $-. ordered\'tinch "']	['Hierochloë (Gramineae) in  the Northern Hemi-']
['mag the week interrupt thera worldsMer also hierarchy NoSel the']	['sphere. - Bot. Notiser 124: 129-175.']
[' exciting right leaks code And Our href Jen asking home OS']	['Hierochloe alpina Roem et Schult']
[' Rhode in seems Our Girls seems 2012 the']	['Holcus alpinus L.']
[' PDT formerING the']	['Gronland.']
['ate her send']	['1849']
['DL result theayBUGens thear the after the q the']	['Rug Fr. Graf. 3, J. H. W.']
[' exciting right leaks shrugged Our href result shareholders banking campaign over Petr from']	['Hierochloe alpina Roem et Schult']
[' Huang in Our Sh survival Kings Karl']	['Holcus alpinus Lin']
['ayBUG formerING']	['Gronland']
[' Investor vacant overpowered in assign spoonville from Under the $ aisleco the']	['Cystopteris fragilis (L.) Bernh']
[' AP sit theat grand']	['emend. Lim']
[' delegates If described the batteries tie Andaded shots']	['1951 determ. Kai Larsen']
[' exception crafts reduced apart contractor reduced en the']	['DEN DANSKE ARKTISKE STATION']
[' ignores Sci the drainage stay dan the']	['DISKO. GRØNLAND.']
[' Investor vacant overpowered in assign spoon peeledstr the aisle remains the']	['Cystopteris fragilis (L.) Berkh']
[' Organization Officer, partly BrightComment, mistakes 50 from, trends']	['Disko, Mellemfjord, Kuanit, 69°43']
[' Department $Does Fighting the']	['9.XIII 1911.']
[' haven the Russia the backyard in response do the']	['leg. Morten P. Porsild.']
[' children clouds remains instit backyard logical do the']	['& Thorbjorn Porsild.']
['ages interrupt projectEXT Pittsburgh']	['Museum Botanicum Ha']
[' notahs walk�ia focal areas']	['(Label for data hano']
[' Burns']	['Number']
[' clout). consumer India arriving build']	['Specimen EQAR']
[' widelyee system calendar Gam contemporary']	['Locality 62555005']
['']	['Altitude']
[' recipesian pets intense villages']	['Date 16061878']
[' secondly']	['Collector AK']
[' official the markets the Domestic proper result statement the systemcv even Gamone']	['M.G. 1 : 39  6255 5005']
[' If from the Grand thereatment description above tallest Dirk mix her bicycle']	['det. 31. 3.1971  Lars Klilm - Nielsen']
[' skills foster Quick partial peeled fiscal inoux mund shots aensayBUG formerINGate Guardian,']	['Dansk geologisk Undersegelse af Grønland 1878,']
[' They the India retailers intor Hust� This)-ieve Our Memorial NH']	['2. Equisetum arvense var. alpestre']
['year do Saintick']	['Wahlenb']
[' lookingburgh shareholders Model a']	['Bjørnesund 63°']
['ianaying). the']	['16 Juni.']
[' last theDOWN right name the']	['A. Kornerup.']
['ages interrupt projectEXT Pittsburgh sidelined Dund']	['Museum Botanicum Hauniense']
[' blazegone Grace buriedANA 24 Mitt parties exceptionaw in shows adequately No grave']	["Treårsekspeditionen til Christian den X's land 1931-33"]
[' supplied prote']	['. Northeast Greenland']
[' United the']	['No.']
[' detriment). thous And a APR flaws 2012 the']	['Saxifraga aizoides L.']
['phy Principal45 really thinkING alsoathy thoroughstop Bean']	['Wollastone Foreland: Kap Giesecke']
[' Areas the thrilled rifle research� interest the,27 the schools rifle ve� Johnson the']	["Lat. 74°30' N., Long. 21°40' W."]
[' even the a ace theules']	['1. aug. 1933']
[' Sed the nothing Komren']	['Leg. Paul Gelting']
[' acceptance the result tantal do Huang 24']	['Det. Kjeld Holmen']
[' Community¢, Releases Hard']	['Un 02,201-5']
[' chairs commit evenawei Over ideas Lovco the']	['Papaver dahlianum Nordh.']
[" Flag the't Secondary cementeme, pen levelsí Bon rep the fully"]	['Det. Heidi Solstad, Reidar Elven  Oct. 2013']
[' as salariesomic to rest renovationsING predicts']	['THE NORWEGIAN EXPEDITION TO EAST-GREENLAND 1930']
[' chairs commit fashionable BC ideaszb from remains the']	['Papaver radicatum Rottb.']
['phy Principal45 really thinkING also Mad But kilograms former']	['Wollastone Foreland: Landingsdalen']
['imer teams resolutions commissioner']	['21. juli 1930']
[' haven the sentimental culturallin']	['leg. Jakob Vaage']
[' skills foster Quick partial peeled fiscal inoux mund shots aensayBUG formerING332']	['Dansk geologisk Undersøgelse af Grønland 1879']
['anooga BearsfaceningcksU crying']	['Lūzūla hyperborea. RBr.']
[' happy sustainable from Grey, interest the campaignBUG overComment, voter 62 Federal the looking statement the']	["Kingigtok, N.Strömfjord, 67°45' n. Br."]
['94 pilot statement approximately IND evenoux from from']	["600 m = 1900'0.H"]
[' National the loser). the']	['12. Juli']
[' last theDOWN right name the']	['A. Kornerup.']
[' looking remains the Camco the confirmedAsh']	['Herb. Joh.Lange']
[' outcome AndOCK ticketseria limit theieve enjoy And 2012 Petr in from pitch the']	['Poa pratensis L. var. domestica Laestad.']
[' Eagleanco consumer aens Crimes Petr assignayBUG PublicING']	['Opsommen af Tiö fu Grönland']
[' states remains GoldenWashington,']	['Bot Have 1860.']
[' last And FROM 1942 Berkeley Liberia Yellowstone in the']	['Asplenium viride Huds.']
[' AP850 Cantor escal APto in today 24- OpenGL asking']	['In rupibus in recessu intima sinus']
[' resultoux former apart offseason Rap Wateruses thinkRegarding in":" famous']	['Kangerdluarssuk prope Frederikshaab.']
[' resultFr PDT 24ING Share would inequality']	['16/8 1886. Groenlandia merid.']
[' TMZ the Huang the']	['Th. Holm.']
['j']	['1']
['race argument Autoorts utilized Jets']	['Potentilla tridentata']
['resistant popularity lot Dar104']	["K'ornok 4/8 1890"]
[' Russia the previous the any468 24 shareholders']	['P.A.Sórensen']
['we rifleait� interest State�']	["60°43' N"]
[' Russiaoux Brooks bowlat tables']	['Prikket S1.']
['Jewish periphery Katie 24 aenscooux former Results']	['Lycopodium alpinum L.']
['sec think tasked remainsElect']	['Julianehaab 1848.']
[' via remains the India theU remains the folded looking the bicycle']	['Hb. E. ROSTRUP.  B. Kruse']
[' Len pressing emphasizing 24ING seeds think']	['Plantae groenlandicae']
[" a unab've displayinginernd Pittsburgh sidelined from pressing the"]	['a Museo botanico Hauniensi distributae.']
[' Midnight seems Pars h storing encourages 2012 the']	['Rubus chamaemorus L.']
[' that official Petr mine features Har way AP Ryan Orlandodisc prescriptions cookie international']	['I Mængor ved en stor Klippeblok']
['sec thinkants interviews']	['Julianehaab']
['425 economy the 2012 the constructive era name Strategy Beckham think a the angrily the schools route the']	['legit Dr. L. Kolderup Rosenvinge a. 1888. 21 aug.']
[' interrupt statement Schwarzenegger83eanhood literature features']	['Botrychium boreale Milde']
[' packets further the Kom bullet histories']	['determ. O Gelert 1897']
[' Len pressing emphasizing 24ING seeds think']	['Plantae groenlandicae']
[" a unab've displayinginernd Pittsburgh sidelined from pressing the"]	['a Museo botanico Hauniensi distributae.']
[' interrupt declined Financial83 zoning Share not confirmed the $at Public the']	['Botrychium lunaria (L.) Sw.']
[' suit the-cash And literature features']	['f. incisa Milde']
['ayBUGburgh� Jude also happy Dublinincreasing in Dublin international herincreasingakura the']	['Groenl. austr.: Kingua Tasersūak - Tasermiut.']
['425 interest therim conference� the pricey the They very mid the']	['legit N. Hartz an. 1889. 219.']
[' India Dennis Sweden ideas arw Dund the']	['Equisetum arvense']
['INGamazon the']	['Gronland 1838.']
[' gunman attackers the']	['Vahl.']
[' economy Stan aridge And official the baby Panzer']	['Draba aurea M.Vahl']
[' Oshco the firearm theander from the transgender discovers Guru']	['29.12.79  Det. Jon Feilberg']
[' economy Stan�cks compared crafts Bu']	['Draba aurea x danriu']
[' If described demonstrate in theinkle inoning']	['determ. Elis. Eksmanux']
[' economy Stan�cks official the cultural attackers']	['Draba aurea M. Vahl']
[' last the movie the target the']	['ett.o.1925']
[' hasht PDT 24ING seeds the']	['Flora Groenlandica.']
[' rpm- Gn 2012 the V the $']	['Draba incana L. (?)']
[' interest in in seems notama Ohio peek former $ 46 from in Gauntlet fossils in looking statement Petr featuresfore Results']	['Narssak (Nordpróven): Sint Skrænt langs Baadehavnen']
[' Bryan reveals overí predict inyearfilloux remainsFXyear do diluted in progressive Chapel metrics right readers Economic $ah decorations IND the']	['imellem Elvens Udlób og Udstedsbestynsboligen). 17/7 1900.']
[' haven the coc partly Cups the']	['leg. Gustav Meldorf.']
['ichING statement83 aensensens lawsuit teams the baby Panzer the']	['Melandrium affine J. Vahl']
[' Flag the Sports from Chaseald Wash']	['Det. Bent Fredskild']
[' Pakistan the RO']	['Jan.1988']
[' exception crafts reduced apart contractor reduced en the']	['DEN DANSKE ARKTISKE STATION.']
[' ignores Sci the drainage stay dan the']	['DISKO. GRØNLAND.']
[' PoorING reapports ideas not build thell statement the $ teams the baby Panzer']	['Melandrium triflorum (R. Br.) J.Vahl']
[' interest Petr in fromayBUG formerING that Sh do kindergarten inizu premiere rifle cut�']	["Vest Grönland, Igdlorsuit. 71°14'"]
[' State evenj aboveowell']	['5 VIII 1911']
[' haven the Russia the backyard logical do the']	['leg. Morten P. Porsild.']
[' children clouds remains instit really in racing']	['& Thorbjørn Porsild']
['ages looking statement']	['Museum B']
[' notahs walkj']	['(Label 1']
[' Burns']	['Number']
[' clout). consumer mov badly']	['Specimen EQSC']
[' widelyee MasterSel grave']	['Locality 6917533']
['']	['Altitude']
[' recipes dancers BoysXbox']	['Date 0809186']
[' secondly shouting']	['Collector RB']
[' Master Digital Transcript']	['6917 5330']
[' If from the last mid former $anu tallest Dirk over " stay Miles shareholders']	['det. april 1971 Lars Kliim - Nielsen']
[' They']	['2']
['ages displaying projectEXT Pittsburgh sidelined Dund the']	['Museum botanicum Hauniense.']
[' India retailers Sweden ideasWatch Amar accompanying todayich developingrises']	['Equisetūm scirpoides Michx']
[' If waiting over also further mund bullet histories']	['determ: O Gelerl 1897']
['425 alsoU crying Bon industryOff voter']	['legit: R Brown 8/9 67']
[' PDT 24ING Share also grunt stall Sh contributing levels the']	['Groenlandia: Disco, Lyngmarken']
[' Len pressing emphasizing 24ING seeds think']	['Plantae groenlandicae']
[" Tri unab've displayinginernd Pittsburgh sidelined from pressing the"]	['a Museo botanico Hauniensi distributae.']
[' repository dumps49- PDT 24ING preceding tree suicides " arriving the']	['Expeditio Danica in Groenlandiam orientalem 1891-92.']
[' Catholic compared policing herd prim Andocated the']	['Carex rariflora Sm.']
[' that scope interest therim in official theat468 24herthal doacist theUoux features aens']	['Leg. N. Hartz ad Scoresby Sund pr. Róde Ø.']
[' mostly rifle proposed� Two rifle search� Figures�']	["70°28'N 28°05'W  16/8 1891"]
[' Payment EXP Juice). displaying project Anaheim Pittsburgh sidelinedeve the']	['Herbarium muse botanici Hauniensis.']
['í Sh Capital NIGHT robberies not awarded the $']	['Elyna Bellardi (All.)']
[' AP to Sharmaased today the']	['in locis siccis']
[' that server tattoo']	['Igaliko']
[' lot route the']	['1828 4 Aug.']
[' teams the cultural attackers the']	['J.Vahl.']
['rer in minority 24 shareholders suit the']	['derm. Stamiautr A.']
[' exception crafts reduced apart contractor reduced en the']	['DEN DANSKE ARKTISKE STATION.']
[' ignores Sci the drainage stay dan the']	['DISKO. GRØNLAND.']
[' Catholic comparedais wickedU looking statement the']	['Carex misandra RBr.']
[' via468 medal Harden way aens interest the campaign trouble Sh the Har way� theinkle December Public in Notice']	['Nordkysten af N. Strfj. ud for. Ekaluarssuit.']
[' voter rifleep�']	["67°35'"]
[' F route, Leah the']	['10 aug. 1918.  leg E. & M.P.P.']
['41 K Nur83CAN disasters overpowered in']	['Polypodium phegopteris']
['-key cafe policy learning areas Petr Public)- in louville policy rights do from']	['in locis subvicuttis sinus Amarak']
[' commissioner WWII the']	['1830 Aug.']
['ayBUG formerING the separated Sh teams the cultural attackers the']	['Grönland. Leg. J. Vahl.']
[' navyEEFit Estate displayinginer NHages, resultoux defendants ow former the']	['Universitetets botaniske Museum, København.']
['ages displaying projectEXT Pittsburgh sidelined Dund the']	['Museum botanicum Hauniense.']
[' uniformspurpose contributing ifomic 24,oulder NoMac firearm $']	['„Danmark" Expeditionen, 1906-1908. 741']
['Nothing in rhythm 50 bankruptcy 2012 the']	['Juncus castaneus L.']
[' If from her Malt from the']	['det. etto.']
[' emphasizing 24ING Share Elsa " rights McCl also causation foster shut']	['Groenlandia bor.-orient.: Basiskæret.']
[" Grand route motiv that commit'right Scarborough rents"]	['31 aug 1907  leg. Andr. Lundager.']
[' Messiah Sub Petr accuser Our Girls ideas']	['Lycopodium alpinum']
[' via statement468 in limit Petr14Frmodern bowl aens']	['Grönland 1886 Facenluk af']
[' via statement result e right name Strategy Southeast think']	['(something). Kolderup Rosenvinge.']
[' not target Petr over Orders escal Awards think exacerbated boundary']	['Calamagrostis hyperbore Lge']
[' If described the clouds Public theat468 24 shareholdersrying']	['determ. Thorv. Sørensen 1952']
[' exception crafts reduced apart contractor reduced en the']	['DEN DANSKE ARKTISKE STATION.']
[' ignores Sci, drainage stay dan the']	['DISKO, GRØNLAND.']
['!), lush 78 contractorfaceningcks displeasure']	['Calamagrostis Lyperborea Lange']
[' Sour " marketsBUG layoffs theincreasing in in attempting FISA Dublin,increasinginch cr " treatmentPick do,we UP resign� interest the']	["Syd-Grønl. Taserssûp Qingua, Tasermiut-Fjord, 60° 16' N."]
[' injunction No bound the loser). vis the last the officers the backyard logical do children official the la the la rights logical do the']	['27.--28. Juli 1925.  A. E. Porsild & M. P. Porsild.']
[' interrupt declined Financial83eanhood officialoux features']	['Botrychium boreale Milde']
[' packets furtherps Neither histories the']	['determ. OGelerl 1897.']
[' interrupt declined Financial83 zoning Share theat Public the']	['Botrychium lunaria. Sv.']
[' India PDT 24ING Sharewe rifle weekDC rifle knee�,']	["E Groenlandia 60° - 72°48'."]
[' teams the cultural attackers the']	['J. Vahl.']
[' interrupt declined in from83 Novemberhey']	['Botrychium lunaria']
['- That KingsWilliamsn Sharma result468']	['in locis graminosis Kor']
[' her Cam famous Mack today Sar in in Senaten from']	['fvak sinnus Tesfarmiut']
[' loser).']	['1828 Juli.']
[' Payment EXP Juice). displaying project Anaheim Pittsburgh sidelinedeve the']	['Herbarium muse botanici Hauniensis.']
[' ALLality)}inqu Ladies 2012ps the']	['Arctophila effusa Lge.']
[' Flag the Camco the displeasure Mikhail the']	['Det. Joh. Lange 1885.']
[' outcome And suit Ernst OS']	['Poa sudetiia']
['ouble think']	['pendulina']
[' AP limitoux Sal have former accordingly today askedshot interviews']	['in locis humidis Godthaab']
[' zombie loser).']	['1830 Juli']
[' skills foster Quick partial peeledFX assembled foster fiscal inoux mund shots']	['Dansk geologisk og geografisk Undersøgelse']
[' aensayBUG formerINGudos']	['af Grønland 1884']
[' Catholic in Xiaomi Andieve- nightmares momentarily economy cocktail the']	['Carex rigida var. infuscata Drej.']
[' theayBUG over main the than Sh Bruce response someone blood baby do not introduce rifleitudes']	["Ø. Grønl. Ingitait Fjord (61°9')"]
[' black route the']	['23 Aug. leg. P. Eberlin']
