[' Len And And think']	['Plantae groenlandicae']
[' a unab). application Pittsburgh sidelined HIV the']	['a Museo botanico Hauniensi distributae.']
[' Pars Graphicsans Mai bicycle']	['Chamaenerion latifolium (L) Scop.']
[' If from the']	['det. Md.']
[' onceguards from the interest468 in Mad shut']	['Ivigtut. Nordlandet.']
[' Guardian crashed the exacerbated theount commonly']	['5/8.1899. leg. Lindhard.']
[' exception NH apart Thank en the']	['DEN DANSKE ARKTISKE STATION.']
[' ignores Sci the drainage stay dan the']	['DISKO. GRØNLAND.']
[' 2012 Petr in from Reform�ibur in 2012 the']	['Saxifraga aizoides (L.)']
[' suit the policy judges disappearrim 24 the']	['f. aurantia Hartm.']
['ayReader the furtherevin face the face the stay rights do 24,']	['GROENL. OCCID. W. Disko, Nordfjorden,']
[' iOS opposing Master rifle Areas the Elsa the']	["Storedal 69°55' Lat. bor."]
[' Department the Center categor the']	['9. August 1923.']
[' last the backyard logical do the']	['A. E. Porsild.']
[' Len AndIM fentanyl']	['Plantae groenlandicae']
[" a unab've Pittsburgh sidelined threats pressing the"]	['a Museo botanico Hauniensi distributae.']
['stick hunt do thread theieve']	['Carex nardina fr. var. hepburnii']
[' notllBUG reference $']	['(Boott)']
[' PDT sit from the']	["Groenl. occ. Tasiusak, 73°25'N."]
[' lot result statement thelessnessieve clouds Share doens']	['4 Aug. 1916 legit Thorild Wulff']
[' exciting right leaksoux Our href not pinned right childrenhaired slated']	['Hierochloë alpina (WILLD.) ROEMER & SCHULTES']
[' Ryanuled the Our href']	['ssp. alpina']
[' Flag thehate medal founder']	['Det. Gunnar Weimarck 1970']
[' could mix delete,ay the unreal literal believes 24 aens']	['WEIMARCK, G. 1971. Variation and Taxonomy of']
[' exciting right leaksBow not feminist over $']	['Hierochloë (Gramineae) in the Northern Hemi-']
['mag the week interrupt worldsMer also hierarchy the']	['sphere. - Bot. Notiser 124:129 - 175.']
[' exciting right leaks optimized Our href not any focused the official the']	['Hierochloe alpina (Sw.) Roem. et Sch. s. str.']
[' If described theat468 24 shareholders']	['determ. Thorv. Sørensen 1952']
[' incurning And a Stuff Bears']	['Hierochloa alpina']
[' Jen shareholders']	['Boem.']
[' AP seedvilleManeria Sharmasap This slam']	['in locis arenosis apricis ad latera in']
[' collateral skilled113 from Mitt in tonnes do']	['feriora alpinum sinus Isortok']
[' not 80ouxShares from the $ admins the']	['(Holst.) 1832 Aug.']
[' navyEE reachings� Typically parks former the']	['Universitetets botaniske Museum, København.']
['ages Pittsburgh sidelined Dund the']	['Museum botanicum Hauniense.']
[' publisher646']	['Arctic Plants']
[' Care (. Controller candle']	['collected by the MORAVIAN BRETHREN 1847 - 1856.']
[' notSTON official the Russia rights logical doANA in to. hasht of joined "']	['(See M. P Porsild: Stray Contributions to the Flora of Green-']
[' shows Illuminati the week Poorco the looking do the Ja, Unitedar therap sq']	['land XII. - Medd. om Grønl. Bd. 93, No. 3 (1935), p. 84-94)']
['race argument Auto']	['Potentilla tridentata']
[' cool the']	['Ait.']
['ayBUG formerING']	['Grónland']
[' marsh former the']	['Reyfs Grfen']
['U the instead the']	['JHW.']
[' navyEEFit in from Petr fromdy shots']	['Universitetets botaniske Museum, København.']
['ages the']	['Museum botanicum Hauniense.']
[' publisher646']	['Arctic Plants']
[' Care (. Controller']	['collected by the MORAVIAN BRETHREN 1847 - 1856.']
[' notSTON official the Russia rights logical doANA in to. hasht of joined "']	['(See M. P Porsild: Stray Contributions to the Flora of Green-']
[' shows Illuminati the week Poor former the looking do the Ja, United the batters As 18 thecht']	['land XII. - Medd. om Grønl. Bd. 93, No. 3 (1935), p. 84-94)']
[' MessiahRes 24']	['Lycopodium alpinum']
['oul Sweden ideas00 tragedy the']	['Trisetum spicatum (L.) Richt.']
[' black the intense theander from theat468 24 spar from sheet former']	['25.9.1979 Det. Søren Hanfgarn']
[' missing AndLog in over rents']	['Aira subspicata B. major.']
['- China Sharma have former recommended in']	['in locis sanosis subsicis sub. alpium']
[' interestoux name international slam Sh Public)- suit468 Kings lookingReg costume today']	['Nûgârssúnguaq sinus Baals Revier']
[' spherical route the']	['1831 aug.']
[' small Public the arise unlimitedunts']	['evt. E. x trachyodon A.Braūn?']
[' Teaching']	['Material insufficient']
[' states compared declined bicycle numer $']	['Det.: Henry Nielsen 1991']
['00 the could right sensing bicycle Chich blood mainrises']	['E. variegatum perhaps more likely! var. wilsonii Newman?']
['t from the rebuilding filmmaker']	['det. Maj 1871']
[' Burns']	['Number']
[' clout). consumer']	['Specimen']
[' widelyee']	['Locality']
['']	['Altitude']
[' recipes']	['Date']
[' secondly']	['Collector']
[' Len And And right']	['Plantae groenlandicae']
[" a unab've Pittsburgh sidelined settled pressing the"]	['a Museo botanico Hauniensi distributae.']
[' reimburse Sweden ideas India retailers argument']	['Equisetūm variegatūm Schleich.']
[' that opinion do the']	['I Vand.']
[' PDT argument statement also happy 24increasing grand from']	['Groenl. austr.: Kingūa Tasersūak : Tasermiut']
['425 statement the pricey the Department']	['legit N.Hartz an. 1889 2/9']
[' Payment83 Juice). Pittsburgh sidelined in the']	['Herbarium musei botanici Hauniensis.']
[' Messiah periphery accuser']	['Lycopodium annotinum L.']
[' looking the Our Memoriallenerim 24 the']	['B. alpestre Hartm.']
[' Flag the Camco the displeasure']	['Det. Joh. Lange.']
['- from Investigatorsath 1925 seems']	['in locis siccis subapricis aitpedes']
[' aensj Movement loser Public remains the']	['alpium sinus Isortok ft Holstb.']
[' admins route the']	['1832 Aug.']
[' Community survival, ofally']	['Univ, of Michigan']
[' Wright Share Trevor Publiceve not previous the looking statement the']	['Woodsia ilvensis (L.) R. Br.']
[' expensive,tering']	['Sept, 1956']
['ant someone the regular']	['Donald F. M. Brown']
[' Dow shareholders Ch limit Petr Owners in']	['Woodsia ilvensis']
[' Processor think Dave officialoux homeiky']	['Fiskesnæsfet Holboll 1843']
[' Investor slowedUPgren praying']	['Cystopteris fragilis (L.) Bernh.']
[' AP sit from the']	['emend. Lim']
[' Cosby from DJ If your in farewell']	['April 1959 determ. Kai Larsen']
[' Payment83 Juice). Pittsburgh sidelined in the']	['Herbarium musei botanici Hauniensis.']
[' Catholics join assign spoonville']	['Cystopteris fragilis (L.) Bernh.']
[' interest468 mund in todayowment']	['Nordgrónland 1861']
[' not You levels former $ Johnsonco blood CW inyear prescriptions in $']	['R. Brown (Whymper Exped.)']
[' Len AndIM fentanyl']	['Plantae groenlandicae']
[" a unab've Pittsburgh sidelined"]	['a Museo botanico Hauniensi distributae.']
[' Catholic from Noahicators in 2012 the']	['Carex capillaris L.']
[' PDT 24 from the Ana usage113 bus do']	['Groenl. orient. Scoresby Sund.']
[' Strategy But in emptiness from']	['Rosenvinges Bugt.']
[' research very her Jennings the']	['20/8-1924']
[' wh lastlin name']	['legit O. Hagerup']
['oul atomicWriting Labor And mont ensure']	['Triglochin palustre']
['- limitoux Sal OpenGL asking']	['in locis humidis Igaliko']
[' route the']	['1828 Aug.']
[' They the internationalFX assembled international fiscal inoux mund shots']	['2. Dansk geologisk og geografisk Undersøgelse']
[' aensayBUG formerING angrily the']	['af Grønland 1883.']
[' Investor vacant slatedievekeyarrow famousilar Train']	['Cystopteris fragilis var. lobulato-dentata']
['weanger statement the that taught ensure international, equality Federalfill statement lamb']	["60°53' Ø. Gr. Iluileq, 700 meter alt."]
['we rifle gl�']	["(60°51')"]
[' Department the']	['9. 4.']
[' industry route the']	['8 Aug.']
[' by by by by by by by by by by by by by by by by by by by']	['leg. P. Eberlin']
[' derailed resultnt right inform blood racing']	["65°68'N, Kangerdluarsikajik"]
['j someone the engagementkie']	['17.8.1899']
[' advocate =ages']	['Natural History Museum of Denmark']
[' Payment EXP00']	['Herbarium C']
[' counter United the 80 extends']	['Image No. NHMD-694150']
[' Len And And think']	['Plantae groenlandicae']
[" a unab've Pittsburgh sidelined threats pressing the"]	['a Museo botanico Hauniensi distributae.']
[' repository dumps49 shareholders bleaksection the']	['Expeditio Danica in Groenlandiam orientalem 1898-99.']
[' Messiah SubRes bankruptcy� in Sz the']	['Lycopodium annotinum']
['ar Labor And liking the']	['B pungens (some word)']
[' Packat468 24 shareholders']	['Leg. C. Kruuse. ad Kangerdluarsikajik']
[' Figures rifle industry�']	["65°68'N"]
['ah routekie']	['17 Aug 1899']
[' missing Andathuled exped']	['Aira subspicata']
['- limitouxvilleMandaily from� today']	['in locis apricis sinus Kangerd']
['year levels readers international not MGM bandwidth reference $']	['luarsuk (Kobbefiorden) 1830 Juli']
[' navyEE reaching,year do Derrick']	['Universitetets Botaniske Museum, København.']
['ages Pittsburgh sidelined Dund the']	['Museum botanicum Hauniense.']
[' incredible retains foster drop in from " marketsBUG formerINGrying the']	['Botanisk Rejse til Vest-Grønland 1932.']
[' Travis nameread Our Sh pride era the']	['Phippsia algida (Sol.) RBr.']
[' Organization from in Darwin over from,strbling).']	['Disko: Kuanit, Diskofjord, i Elvleje.']
[' Garland).j rifle They features from the Camco in the PDTarts This do the']	['No  6/VIII.  leg. et det. Johs. Grøntved.']
['EVA yourread Western apparently Southeast inouth Mitt in tonnes do in']	['Kobresia bellardii (All.) Degl.']
[' tonight minor from Mercury sailors Sh k rifle']	["Atanaitsunguaq 70°22'"]
[' lot fr sells last India backyard logical do']	['4-8-1921 A E Porsild']
[' gene from, Camcoate brew']	['Herb. Joh.Lange']
[' outcome And Your gets']	['Poa glauca Vahl']
[' 18,� Balance from the']	['B. elatior Lge.']
[' excuse former va Falcons do slam do $ Ch once This blood mainoux blood']	['Sermilik (Bredefjord) i Tunudliorfil']
[' once over the proposed Fam mid the not previous468 Results $']	['Fjord. 28 Juli 1876 (Kornerup)']
[' psychic in tracked in']	['Trisetum sūbspicaticūm P.A.Sórensen Jakobshavn 4/8 1892']
[' in-. Ethan Johnson extends the not underonga Share sixty $']	['Revisionary Studies in the Genus WOODSIA (Aspidiaceae)']
[' Johnson the even relied AndU the Improvement']	['W. glabella R.Brown']
[' expensive thetering']	['Sept. 1956']
['ant someone the regular, services ofally the']	['Donald F. M. Brown, University of Michigan.']
[' Len AndIM fentanyl']	['Plantae groenlandicae']
[' a unab Gond Pittsburgh sidelinedavi operating think the']	['a Museo botanico Hauniensi distributae.']
[' Wright Share expert adapting JustU the!, the']	['Woodsia glabella R. Br.']
[' If from the Camco the 2012 Petr in from Harden way the']	['Det. Joh. Lge.']
[' happypton runtime mostly rifleait� interest statement the']	["Kingarsuak 70°43' n.Br."]
[' must the route the exhaustive']	['7. aug. 1888 legit S. Hansen']
['!), lush desperately not officers tragedy the $']	['Calamagrostis neglecta (Ehrh.)']
[' If described theat468 24 shareholders']	['determ. Thorv. Sørensen 1954']
['!), over rents ET LO today']	['Calamagr. neglecta']
[' predicts If described the00 the via the furtherhew Santos the']	['1926 determ. C. H. Ostendeld.']
[' exception NH apart reduced en the']	['DEN DANSKE ARKTISKE STATION.']
[' ignores Sci stay dan the']	['DISKO, GRØNLAND.']
['!), lush 78 contractoreen union And']	['Calamagrostis Lyperborea']
[' displeasure']	['Lange']
[' Sour " marketsBUGerey Water, that server tattoo " treatmentPick do,we rifle belief�']	["Syd-Grønl. Qagssiarssuk, Igaliko-Fjord, 60° 53' N."]
[' State the route the vis the']	['5. Aug. 1925.']
[' last the India the backyard logical do children official the la the la the la the target the']	['A. E. Porsild & M. P. Porsild.']
['ages']	['MUSEUM BOTANICUM']
[' flowing Hom any the']	['HAUNIENSE.']
[' Catholic comparede swast mism the prior the']	['Carex ampullacea. Good.']
[' than PDT 24ING shots MackFel in schools rifle They�']	["In Groenlandiæ meridionalis sinibus 67° 2'."]
[' teams the cultural attackers']	['J.Vahl.']
['iana markets artistic the']	['FORGIFTET.']
[' emergencies aens83']	['radices alpium']
['rer in shareholders']	['sinus Tasermiut.']
[' owners Sh the that the cultural attackers the']	['Leg. J. Vahl 1829. Aug.']
['ages in taught fromdy shots']	['Botanic Museum of the University, Copenhagen']
[' prote646']	['Greenland Plants']
[' as formerlictnc und to rest prote adequately Skills the']	['The triennial Danish Expedition to East Greenland 1931 - 34.']
[' United State consulting Ez preserve Given nightmares']	['No 5373. Luzula confusa Lindeb.']
[' thatara premiere rifleep�']	["Lat 71°35'N"]
['27 the challenge rifle black�']	["Long. 22°25'N"]
[' explored the']	['Alt.']
[' performing the� Mad also yogurt Toronto installment']	['Loc. Canning Land: The Isthmus between']
['AND shareholdersFX oncePick from aens']	['Carlsbay Fjord and Nathorst Fjord.']
[' recipes also research result statement Either']	['Date: 30. VII 1934']
[' haven the clouds Public theat468 24']	['Leg. THORV. SØRENSEN']
[' Flag the United the State the']	['Det. Th. S.']
[' outcome And Labor And']	['Poa pratensis macrorrhiza']
[' Ch tree Please And']	['ianisia']
['']	['Wahl']
['- do Investigators from� in468 mund in today']	['in locis fertilioribus sinus']
[' policy). framework international zombie']	['Amaralik 1830 aug.']
[' Russia the']	['P. pratensis']
[" outcome AndFX season liking fair.'':// Toronto115"]	['Poa flexuosa var. elongata Alyth']
[' Facebook the']	['J.L.']
[' Euras']	['1876']
[' underonga83 uprising sustainable not any Public $']	['Aspidium Filix mas (L. / Sw)']
[' rendering doBUG14, Moon Conor va organic rifle Lions�']	["Sydgrönland, Paniagaluk 59° 55'."]
[' suicides smallLegend in Scarborough the']	['1891 Eleonora Lundholm.']
[' navyEE reaching, shape do China exp former the']	['Universitetets botaniske Museum, København.']
['ages Pittsburgh sidelined Dund the']	['Museum botanicum Hauniense.']
[' publisher646']	['Arctic Plants']
[' navyEE Bruce And controversysystem,']	['UNIVERSITATIS CAROLINAE BOTANICAE CATHEDRA, PRAGA']
[' Make And Your gets']	['Poa glauca Vahl']
[' OshGP']	['29. 11. 1963']
[' outcome And ET overidy They the']	['Poa nemoralis L.']
['ieve Changes crown the']	['var. glauca']
[' 2012oux remains reaching pushing in IO Just levels']	['Lichtenfels Gronland']
['ich esp Public the Stoke Hungry']	['Mission. Tietzen']
['IRT']	['1853']
[' Len And And think']	['Plantae groenlandicae']
[' a unab former celebrities in Petr shareholders']	['a Museo botanico Hauniensi distributae.']
[' repository dumps49 shareholders']	['Expeditio Danica in Groenlandiam orientalem 1901-2. E3']
[' Pars And right,." overapensoux main shareholders']	['Chamaenerion latifolium']
[' not confirmed $PT Financial']	['(L) Spach']
[' Packat468 24 shareholders disturbed the organism sensing seemingly rifle']	["Leg. C. Kruuse ad. Kingarsuak 66°10'"]
[' challengeaying). streamed']	['22 juni 1902']
[' pool serious the Len And And right']	['367. Plantae groenlandicae']
[' a unab former the']	['a Museo botanico Hauniensi distributae.']
[' outcome And Our href 2012 the']	['Poa alpina L.']
[' that If from- do aens Facebookori']	['I det indoe af Dalen Ø.f. Igdlor-']
[' good the']	['pait']
[' emphasizing 24,FXs, 134 ensure']	['GROENL. OCCIDENT.; Disco, N.V. Kysten.']
[' Navy streamed the Russia the backyard logical do the']	['26. 7. 1902 leg. Morten P. Porsild.']
[' exception NH apart peeled en the']	['DEN DANSKE ARKTISKE STATION.']
[' ignores Sci stay dan the']	['DISKO. GRØNLAND.']
[' Catholic compared LX in fromoux Public)-']	['Carex holostoma']
[' Falcons featuresiated from interest the sentimental shareholders']	['Brede Bugt n. f. Jakobshavn']
[' Master rifleate�']	["69° 18'"]
[' Under industryEm']	['6/8 1915']
[' haven the Russia theiver in Midlands']	['leg. Morten P. Porsild.']
[' Payment83 Juice). Pittsburgh sidelinedeve the']	['Herbarium musei botanici Hauniensis.']
['aying).modern from in Petr fromdy shots']	['Juncus castaneus Sm.']
[' Lov inING Truman not anyVD ow former $']	['NordGronland 1867 (Jakobshavn)']
['U the unfair name not baby cocktail right $']	['R. Brown (Whymper Exped.)']
[' navyEE reaching, shape do China exp asking the']	['Universitetets botaniske Museum, København.']
['ages Pittsburgh sidelined Dund the']	['Museum botanicum Hauniense.']
[' publisher646']	['Arctic Plants']
[' Care (. Controller gut']	['collected by the MORAVIAN BRETHREN 1847 - 1856.']
[' notSTON official the Russia rights logical doANA in to. hasht of joined "']	['(See M. P Porsild: Stray Contributions to the Flora of Green-']
[' shows Illuminati the week PoorayBUG former main the looking do, United thear therap sqacist']	['land XII. - Medd. om Grønl. Bd. 93, No. 3 (1935), p. 84-94)']
[' missing And Our href 2012 the']	['Aira alpina L.']
['kept 24195 in-ayBUG formerING']	['Lichtenfels in Gronland']
[' officialoux home right']	['Mifsiona Tietzen']
['IRT']	['1853']
[' campaign December href 2012 the']	['Aira alpina L.']
[' lin fromleness milestone� 68 Church today']	['Lichtenfels in Gronland']
['ichando Rap Stoke remains kindergarten Sh']	['Mifsiona Tietzen']
['IRT her']	['1853']
[' navyEE reducedages the']	['Universitetets botaniske Museum, København.']
['ages Pittsburgh sidelined Dund the']	['Museum botanicum Hauniense.']
[' Len And And think the']	['Plantae Groenlandicae.']
[' Catholic compared defunct discouraged thread the']	['Carex nardina Fr.']
[' If from the00 from the movie the target the']	['det. etto.']
[' interest theayBUG formerING,phyhew thinkat468 24 shareholders,']	['N.V.Gronland, Wolstenholme Sound,']
[' sent right result main the know Jesse Whatever']	['Saunders Isl.: Agpat']
[' National must']	['12.7.1911']
[' meant thread universe']	['leg. Peter Freuchen']
[' borders Adv49 also detriment). assign']	['Familie: Saxifragaceae']
[' skills foster former her pus remains fixes']	['Dansk navn: Knoje - Stenbræk']
[' Areas former also detriment). thous Androwing Tal And']	['Latinsk navn: Saxifraga cernua']
[' Roof Roof Roof Roof Roof Roof Roof Roof Roof Roof Roof']	['Lokalitet: Jòrgen Brònlund Fj. Pearyland']
[' concealed Gracebut And also psychic indaq the tendaded international fixes']	['Vokseplads (samf.): Fu. Ruos r. Keddelkrogelr']
[' 64 China also lot another right also']	['Dato: 4-7 Findere: Jean Just']
[' seemingly']	['66']
[' that the V the la the']	['I.C.P.']
[' tackles rifle F� research� Johnson']	["82°10'N 30°30'W"]
[' hasht PDT 24ING seeds the']	['Flora Groenlandica.']
[' Cafe typical from']	['Festuca rubra L.']
[' ch in fromoux features from campaign Goldmanisers rights do from teams14 Dave shareholders']	['Overburestedet Itivdliarssuk Julianehaabs Distrikt']
['ar very histories her']	['13/7 1897.']
[' haven the cocens the']	['leg. Gustav Meldorf..']
[' exception NH apart reduced en the']	['DEN DANSKE ARKTISKE STATION']
[' ignores Sci, drainage stay dan the']	['DISKO, GRØNLAND.']
[' further This bloodFX']	['Pucc. Vaginata']
['cigarettes the TMZ theat the niche']	['det Th S 1949']
[' Romeo " marketsBUGpadding international someonePick do, FISA Dublin premiere rifle must interest the']	["Vest-Grønl. Qaumarujuk Fjord, Qingua, 71° 7' N."]
[' injunction loser). batters,']	['27. Juli 1935,']
[' official the backyard logical do the']	['M. P. Porsild.']
[' exception NH apartville reduced en the']	['DEN DANSKE ARKTISKE STATION']
[' ignores Sci stay dan the']	['DISKO, GRØNLAND.']
[' presents components Your And 2012']	['Salix glauca L']
['ayReader Georgian the further do the interest skipped Bradley riflear riflejara the Elsa the']	["GROENL. OCCID. ca. Neria 61° 33' lat. bor."]
[' National must Australia']	['12/7 1924']
[' haven the teams the compassion volunteers throws the']	['leg. J.Eugenius.']
['oul ideas not V Solid $ 2012oux This']	['Trisetum triflorum (Bigel.) Löve & Löve']
[' National the methods occupies']	['12.11.1979']
[' Flag the Oregon discovers Guru']	['Det. Jon Feilberg']
[' missing And devastating in Ox operating']	['Aira Subspicata']
['- limitouxville a demolitionville']	['in locis apricis Nennese']
[' loser). the']	['1829 Juli.']
[' skills foster Oklahomaco fiscal in mund shots aensayBUG14ate brew']	['Dansk geologisk Undersøgelse af Grønland 1878']
[' blessed Bears Android funding 2012 the']	['Betula nana L.']
[' Multi Marathon Grid Labor And interest468 in formations aens Processor right Tal']	['Utilivik paa Nordsiden af Fiskernæs-']
[' someonePick easier']	['Fjorden.']
[' Stateaying).']	['5 Jun.']
[' last theDOWN right name']	['A. Kornerup.']
[' Facebook theTesting And']	['d. arctica']
[' 2012 theAkbank']	['L. Koch']
[' schools decorations spinal']	['21/7.16']
[' navyEE reaching, shape do in Petr Public former the']	['Universitetets botaniske Museum, København.']
['ages Pittsburgh sidelined Dund the']	['Museum botanicum Hauniense.']
[' Len And And right']	['Plantae Groenlandicae.']
[' Facebook Thank resur unfinished small reference right AP']	['Deschampsia caespitosa (L) P. Beauv.']
[' Har way from Edwin not fourthval the $ tomatoes the']	['var. arctica (Tsin.) Simu.']
[' official the joinedlahat468 24 shareholders']	['NW Greenl., Walstenkoline Sound:']
['year MusFX Ant foe']	['Umanaq, old dry skingle']
[' Har way']	['bed.']
[' schools thelessness the']	['21.7.1916.']
[' haven the']	['leg.']
[' displeasure constructive from']	['Lange Koch']
[' capitalist']	['Equisetum sylvaticum']
[' even']	['Linné']
['- from Investigatorsathark Sharma aens']	['in locis subhumidis ad radices']
[' Our Girlsaily todaysigned district']	['alpium sinus Amaralik']
[' Ez the someone the cultural attackers']	['Leg. J.Vahl']
[' spherical loser).']	['1831 Juli']
[' Len And And think']	['Plantae groenlandicae']
[" a unab've Society sidelined"]	['a Museo botanico Hauniensi distributae.']
[' repository dumps49 shareholders']	['Expeditio Danica in Groenlandiam orientalem 1901-2.']
[' Indiaar']	['E3']
[' Pars right83 limit Petr fromLayout']	['Chamaenerium latifolium']
['ensivePT Financial the']	['(L.) Spach.']
[' suit the Ryansunilling']	['f. stenopetala']
[' owners blood the00 thearel Koch']	["Leg. C. Kruuse ad. Tunak 65°55'"]
[' system route the streamed']	['6 Aug 1902']
[' navyEE reaching,year difference escal former the']	['Universitetets botaniske Museum, København.']
['ages Pittsburgh sidelined Dund the']	['Museum botanicum Hauniense.']
[' uniformspurpose contributing UPomic, actorsVILLE the They Thus']	['„Danmark" Expeditionen, 1906-1908. 237']
['Nothing in 2012 the']	['Juncus biglumis L.']
[' her If from the00 theyear the instead the']	['- det. etto.']
[' emphasizing in over boundary And Elsa from the']	['Groenlandia bor.-orient.: Kæret ved Vester Elv']
['ah loser). motiv limit Petr in from']	['17 Juli 1907 leg. Andr. Lundager.']
['ages']	['MUSEUM BOTANICUM']
[' flowing Hom shots the']	['HAUNIENSE.']
[' Catholic former� swast mism ThomasIM�']	['Carex ampullacea. Good. FORGIFTET.']
['-annedIn JD a do']	['In paludosis ad']
[' emergencies aens AP113 from']	['nadices alpium']
['rer in that server tattoo']	['sinus Igaliko.']
[' 2012 Petr inj instead Panzer']	['Leg. J. Vahl 1828. Aug.']
[' navyEE reducedages the']	['Universitetets botaniske Museum, København.']
['ages Pittsburgh sidelined Dund the']	['Museum botanicum Hauniense.']
[' Muhammad Oy ideasacular mid the Federal theayBUG formerING journalism actors whereas the']	['Jubilæums Expeditionen Nord om Grønland 1920-1923.']
[' Russiameter creativity Share Columbia Sentinel And390 in pocket slam in from tweeting the']	['Puccinellia phryganodes (Trin.) Scribn.']
[' negotiations have former the']	['& Merr.']
[' interest the Johnson the PDT do shareholders shareholders, Russia the could move contributing']	['N.W. Greenland: Washington Land, Pustersnack']
[' interest the Areas the delivered the weight rifle,']	['N. Lat.: e.80°,']
[' displeasure']	['Lauge Koch']
[' bring brew the']	['13/8 1921.']
[' haven the teams thechanging Tah sensing']	['leg. [J. Noe Nygaard.]']
[' If described the00 the Comfortleness the']	['determ. C. H. Ostensfeld.']
['ages in Petr reference K, withstand']	['Botanic Museum of the University, Copenhagen']
[' prote646']	['Greenland Plants']
[' as from Go Decembernc). though to rest prote adequately weekuc the']	['The triennial Danish Expedition to East Greenland 1931 - 34.']
[' United Lions theAK consensus exp grand preclude in frompat Mitt']	['No 55 12. Eriophorum polystachyum L.']
['ieve rulings today result statement the']	['var. tristis Th Fr.']
[' Areas thrilled rifle system� Two�']	["Lat 74° 06'N"]
['27 theyear do k even']	["Long. 21°20'W"]
[' explored the Figures Federal the']	['Alt. 75 m.']
[' 2012 government result main also interest 18AKco in minerals bankruptcy']	['Loc. Clavering Isl: N.W. of Eskimonæs']
[' recipes also k the subscriber made batters']	['Date: 20.VII 1935']
[' haven the clouds Public theat468 24 shareholders']	['Leg. THORV. SØRENSEN']
[' Flag theDC the']	['Det. Th S/.']
[' season liking ThomasIM']	['S. flagellaris Willd']
[' Ryanuled theshots todayigraph not TessInoned $']	['ssp. platysepala (Trautv.) Pors.']
['ating described alsowellEle fromoux vig batters']	['Determ.: Eric Hultén. 1963']
[' Manchester Steve Only26 Petr main "olerance nucleus PVC Atlas the']	['Zweite Deutsche Nordpol-Expedition 1869-70.']
['omic And 2018']	['Expeditionsschiff,,Germania."']
[' detriment). scouts the artists typical inmer right']	['Saxifr. Flagellaris Willd']
[' furtherrdEverybody inayBUG from sensing']	['Oestliches Grönland: Sabine-Insel, [Clavering Insel.]']
['iana markets artistic the']	['FORGIFTET.']
[' Len And And right']	['Plantae groenlandicae']
[' a unab former skeptical from asking the']	['a Museo botanico Hauniensi distributae.']
[' repository dumps49 shareholders']	['Expeditio Danica in Groenlandiam orientalem 1901-2. E3']
[' Pars right83 limit Petr Stuff']	['Chamaenerion latifolium']
[' by schoolsat blood Petr medal']	['(L) Spoch']
[' haven00 thearel Economic shareholders']	["Leg. C. Kruuse ad. Ikerasausak. 66° 5'"]
[' researchaying). streamed']	['30 Juni 1902']
[' navyEE reachings� engine And spreading']	['Universitetets botaniske Museum, København.']
['ages Pittsburgh sidelined Dund the']	['Museum botanicum Hauniense.']
[' Len pressing PDT 24ING']	['Plantae Groenlandicae.']
['anooga BearsOGR Ladies']	['Luzula confusa']
[' Flag the last the baby the']	['det. ett. o.']
[' instead survival neuro think, Drag This bloodFX Har way']	["V. Grónland, Giesecke's Sø ved"]
[' HBO resultoux blood difference nother in Paramount Solid Falcons Public $']	['Nordre Strømfjord (sydvestlige Bred).']
[' West fr panels the Har way Development barrels asking']	['11-8-1911 leg. V. Nadmann']
[' navyEE reachings� engine And390']	['Universitetets botaniske Museum, København.']
['ages Pittsburgh sidelined Dund the']	['Museum botanicum Hauniense.']
[' Len And And think the']	['Plantae Groenlandicae.']
[' Catholic compared850 inán in Mitt the']	['Carex rupestris All.']
[' letters metrics bicycle." over also']	['N.W. Greenl. Wolstenholme Sound:']
['year men scope the']	['Umanaq.']
[' Guardian resignt consume think resultoux features the']	['7.8.1916 leg. Lange Koch.']
[' cynical hus83 distinguished in tonnes the']	['Epilobium lactiflorum Hausskn.']
[' Flag rightn way ( planned00 Maze']	['Determined by Peter C. Hoch']
[' hill consensus adoptionAND 24ulu']	['Missouri Botanical Garden 1977']
[' Ambassador the']	['831.']
[' cynical hus83 Frankfurt468 your']	['Epilobium Hornemanni']
[' suit Ernst Dig And110 shareholders the']	['f. Lubradorica Hausskn.']
[' Organization Officer, bicycle suit,DOWN Chevron features from']	['Disko, Mellemfjord, Kvindstedet']
[' National the industry the streamed the']	['12.8.1902']
[' official the backyard in response the']	['MP. Porsild.']
[' Unitedj road']	['Nr.11100']
[' black']	['25']
[' term Sub Petr home today']	['Alopecurus']
[' Our mid survival Tal']	['alpinus']
['apolis aens resultoux remains tickets asking']	['Eng v/ Kobberaa']
[' titled over ensure']	['Thule']
[' her research decorations proper']	['30/7 39']
[' afflicted the clouds Maintenance shareholders']	['leg. Thorlaksson']
[' transgender NH Loan ensure in Adventure MadANA']	['Den danske Thule-Ellesmere Land Ekspedition']
['ages in taught fromdy shots']	['Botanic Museum of the University, Copenhagen']
['646 of Criminal']	['Plants of Northwest Greenland']
[' difficult.nc asking MadANA']	['From the Danish Thule-Ellesmere Land expedition']
[' pitchers tighten the']	['1939-40.']
['kan Volks from00 the Hall']	['PRIKKET C. BAY']
[' lastricting Basin inocated the']	['Alopecurus alpinus Sm.']
['apolis the']	['Eng.']
[' explored the']	['Alt.']
[' performingesville boundary,']	['Loc. Kobberå, Dundas']
[' delivered the checks rifle interest the techniques rifle Johnson the']	["c. 76°34' N. 68°48' W."]
[' recipes also recognition proper the Westonson']	['Date. 30.7.39 No. 11125']
[' haven theay the clouds main']	['Leg. G. Thorláksson']
[' Flag the result the sentimental shareholders']	['Det. K. Jakobsen']
[' react And ET heck today']	['Poa nemoralis']
['ay the last theat468 24 shareholders']	['P.H. Sorensen']
[' India costume today over 50 loser). disproportionate the']	['Egedesminde Juli 1894']
[' cynical hus83 Go). memor 24 remains the']	['Epilobium hornemannii Reichenb.']
['athuled the effectiveness think']	['subsp. hornemannii']
[' Flag right over aggress ( planned00 tragedy the']	['Determined by Peter C. Hoch']
[' hill in int). machine']	['Missouri Botanical Garden']
[' tuition']	['1978']
[' anypartisan occasions shockingly468 reduced']	['DEN DANSKE ARKTISKE STATION.']
[' ignores Sci stay dan the']	['DISKO. GRØNLAND.']
[' cynical hus83taking pri bankruptcy']	['Epilobium hornemannii']
[' asked ow former']	['Godhavn']
[' deliveredput, Australia industry realm French']	['Disko, 24.8.1912']
[' haven the clouds remains instit backyard logical do the']	['leg. Thorbjørn Porsild.']
[' exception NH apart Thank en the']	['DEN DANSKE ARKTISKE STATION.']
[' ignores Sci stay dan the']	['DISKO. GRØNLAND.']
[' Meter typical Europeans features not confirmed $']	['Capsella bursa pastoris (L.)']
[' would do the']	['med.']
[' Sour " marketsBUG attackersoux remains gunshot international " treatmentPick do,we rifle Lions� interest']	["Syd-Grønl. Narssaq, Tunugdliarfik-Fjord, 60° 55' N."]
[' industry the route the vis the']	['8. Aug. 1925.']
[' last the India the backyard logical do']	['A. E. Porsild & M. P. Porsild.']
['ages']	['MUSEUM BOTANICUM']
[' flowing Hom any cocktail']	['HAUNIENSE.']
[' limit right Xiaomi think the']	['Carex rigida Gooden.']
[' Value BCands in economy cocktail the']	['saxatilis Drej.']
['iana markets artistic the']	['FORGIFTET.']
[' haven the that the cultural attackers Berserker the route the']	['Leg. J.Vahl 1834. Aug.']
[' a doas district']	['ad later inferio']
[' policing Our Girls over once468 Con']	['ra alpinum Terri']
[' across Mumbai." overyear union Go']	['Torii colon. Uperni']
[' Berkeley international her']	['vik -']
[' skills foster Quick Aristotle peeled fiscal inoux mund shots']	['Dansk geologisk og geografisk Undersøgelse']
[' aensayBUG formerING Mikhail']	['af Grønland 1885.']
['str Oklahoma buried83� right Marathon in Senateick 24']	['Lycopodium annotinum ß. alpestre']
[' system Sh the']	['Wg.']
[' instead theayBUG Public main the']	['V. Gronl. Kunguk. ca 65°']
['ar loser the']	['3 Jun']
['str theat the skeptical']	['by. S. Hansen']
['protect of Ell desktop']	['FLORA OF THULE']
[' saves of banking']	['REGION OF ETAH']
[' United the Ambassador']	['No. 83']
[' Make And sensing']	['Poa glauca Vahl.']
[' turnout disappears,").']	['Rocky delta, Etah.']
[' route the indeedEm the']	['aug. 13, 1915.']
[' Johnson theí AND']	['W. ELMER EKBLAW']
[' stereotypical SuchINGomic']	['CROCKERLAND EXPEDITION']
[' Areas Imm Guardian rifle k� interest']	["Latitude 78°20' N"]
[' that nationwide from altogetherFX They research� Johnson']	['Longitude 72°30 N']
[' navyEE reaching,year do in Senate the']	['Universitetets botaniske Museum, København.']
['ages Pittsburgh sidelined Dund the']	['Museum botanicum Hauniense.']
[' Len 50 seeds think the wet']	['Plantae Groenlandicae. 1495']
[' Catholic from policing And not Scott Sh $ throughout']	['Carex rariflora (Wg) Smith']
['ans Grace railwayPick do strategy brew Fighting']	['Laksefjord 26/8 1911']
[' policy right Scarborough']	['leg. Andr. Lundager']
[' last� 222 throb']	['ALFRED BENZON']
[' via the Kos']	['Yl. Fe. vi.']
[' State rescued herj her']	['J22-1']
[' underking also substance donations in']	['Aspid. Lonchitis']
[' asked ow former the grunt']	['Godhavn. Disco. 69°.']
[' Truman theproof Bruce crying relative']	['1864. Tabita Broberg']
[' resultll Garland candle']	['KJÖBENHAVN.']
[' Beer navyEE reaching lookingoux defendants response']	['Fra Universitetets Botaniske Museum, København.']
[" India unab've Pittsburgh sidelined Dund the"]	['E Museo Botanico Hauniense.']
['description in- 100 " renovationsINGrying the']	['Botanical Investigations in West-Greenland 1932.']
[' Catholic from in rallying from season liking ThomasIMFXat WingFXat Wing']	['Carex lagopina Whbg.']
[' Organization from also socially D Power,sat Beckham chemistry international']	['Disko: South coast, at Sinigfik']
[' Nam thearades the']	['ca. 3 km from the sea shore.']
[' United k veryishes']	['No 207 24/VI.']
[' haven the banking the Camco in theayBUGarts This do the']	['leg. et det. Johs Grøntved.']
[' navyEE reachings� engine And390']	['Universitetets botaniske Museum, København.']
['ages Pittsburgh sidelined Dund the']	['Museum botanicum Hauniense.']
[' publisher646']	['Arctic Plants']
[' Care (Young trailer Controller 1987']	['collected by the MORAVIAN BRETHREN 1847 - 1856.']
[' notSTON official the Russia rights logical do aens Photography in']	['(See M. P Porsild: Stray Contributions to the Flora of Green-']
[' shows Illuminati the week Poorco the looking do the Ja result statement the batters As 18 thecht']	['land XII. - Medd. om Grønl. Bd. 93, No. 3 (1935), p. 84-94)']
[' outcome And Our href 2012 the']	['Poa alpina L.']
[' therefore do shareholders195 in AP IO in JustIM']	['Lichtenfels in Gronland']
['ols in the StokeITED']	['Mission Tietzen']
['IRT']	['1853']
[' advocate =ages']	['Natural History Museum of Denmark']
[' Payment EXP00']	['Herbarium C']
[' counter United the governed extends']	['Image No. NHMD-811868']
['iana markets artistic the']	['FORGIFTET.']
['Former Sports Ey']	['ALFRED BENZON']
[' via the� the knee Ryan the must the']	['ye. fe. vi. 483. of.']
[' They Falcons Public in shrimp do']	['5 Brevifolia']
[' Romeo Journal He 2012']	['Festuca ovina L']
[' asked ow former']	['Godhavn Disco']
[' Master rifle interest the']	['69° N. Ø.']
['owment Minority Bruce']	['1864 Tabita Broberg']
[' result corpses remains Pu former the']	['KJÖBENHAVN.']
[' thatat someone']	['! SF']
[' Cafe KSpeaking slated Johnson,one']	['Festuca brachyphylla Schultes W.5']
['ief']	['1962 det. Kjeld Holmen']
[' Cafe seeds arefil costume today']	['Festuca brevifolia\xa0R.Br.']
['uck State the target theules the']	['! Schol. 1933.']
[' well January ideas not drawn $']	['US NATIONAL HERBARIUM (US)']
[' Make circumst nutrition Ryanuled theockey acquired Comments think 2012 the teams the']	['Poa flexuosa ssp. consauliae L. J.']
['uls todaytimes children MIT stupid']	['Gillespie & Soreng']
[' cases Russia the evenRec fencing']	['toward P. glauca Vahl']
[' Flag theU the MIT stupid, earlier']	['Det.: R. J. Soreng, 2017']
[' Payment EXP last conferences,description construction K of last levels escal']	['Herbarium AAU, Botanical Institute, University of Aarhus']
[' United the']	['No.']
[' interim And onwards gemsay over the']	['Poa flexuosa Gn']
[' Department Lars expertden confirmedoux sensing']	['6/1989 Simon Lægaard']
[' backyard even extravagant']	['Poa glauca']
['at468 24 shareholders pushing instead fixes Santos from']	['Serv Thorv. Sørensen det. J. Naunfeldt']
[' Sund']	['1953']
[' skills foster Quick Aristotle international fiscal inoux mund shots']	['Dansk geologisk og geografisk Undersøgelse']
[' aensayBUG formerING the']	['af Grønland.']
[' outcome And knackn rallying from']	['Poa laxiuscula Lge.']
[' instead468 in Dip']	['V. Grónland: Holsteinsborg']
[' system last crunch the']	['6 Aug.']
['modern bowl Labor And Patriots treatment K Derbym across Sh fromudos aens']	["samlet paa „Fylla's” Togt 1884 af"]
[' whale therelFX TMZ the Huang the']	['Eug. Warming og Th. Holm.']
[' exception NH apart peeled en the']	['DEN DANSKE ARKTISKE STATION.']
[' ignores Sci stay dan the']	['DISKO. GRØNLAND.']
[' Link todaysweUnderAfter the']	['Arabis arenicola (Rich) Gel.']
[' emphasizing 24 main the furtherevin the']	['GROENL. OCCID.']
[' offices rights indicated international, mostly rifle premium�']	["Patorfik, 70° 42'"]
[' injunction loser). gallon the']	['27. Juli 1921']
[' haven last theAKick backyard logical do the']	['leg. A. Erling Porsild.']
[' skills foster the fiscal inoux mund shots aensayBUG formerINGSTR,']	['Dansk geologisk Undersøgelse af Grønland 1879.']
[' lastricting Basin in Our Girls seems theocated the']	['Alopecurus alpinus. Sm.']
[' result predict indie, hanged Graphics aens interest the RussiaBUG overComment']	['Kekertarsuit, Mundingen af N. Strömfjord.']
[' State the loser).']	['5. Juli.']
[' last theDOWN right name']	['A. Kornerup.']
[' Len AndIM fentanyl']	['Plantae groenlandicae']
[" a unab've Pittsburgh sidelined threats pressing the"]	['a Museo botanico Hauniensi distributae.']
[' repository dumps49 shareholders suicides the IND']	['Expeditio Danica in Groenlandiam orientalem [1891 92]. 1806']
[' performing doMax from aens in Capital im']	['Cochlearia officinalis L.']
[' Ch Izzy easier the']	['B groenlandica Gelert.']
[' 2012 Petr Sh interest therim conference a do Guineastr Petr main over the']	['Leg. N. Hartz ad Dunholm']
[' loser). 65']	['Juli 1806']
['ages in taught from from Petr Owners over']	['Botanic Museum of the University, Copenhagen']
[' prote646']	['Greenland Plants']
[' interest experimental Travis ensure ideas Our Constitutional 2012 the']	['No 18.  Phleum alpinum L.']
[' Areas the ont levels indicated compared']	['Lat. Kuiartorfik']
['27 the']	['Long.']
[' explored the']	['Alt.']
[' performing areas the']	['Loc.']
[' recipes also National the subscriber madekie the']	['Date: 12.VII.1899.']
[' Flag the CamBUGarts']	['Det. Johs.Gröntved']
[' haven the teams theount commonly']	['Leg. J.Lindhard']
[' offseasonstones right National decorations the']	['Kuiartorfik. 12/7/99.']
[' Russia shields former aens']	['Phleum alpinum L.']
[' mirrors And Enjoy']	['Lindhard.']
[' Catholic from sincerely supremacy negotiations delivered the Android BCands in 2012 the']	['Care rostrata Stokes X C. saxatilis L.']
['Although, driving']	['10.5.1979']
[' Flag the Oregon discovers Guru']	['Det. Jon Feilberg']
['ages in, withstand']	['Botanic Museum of the University, Copenhagen']
[' prote646']	['Greenland Plants']
[' United the lendmin trader facial operating supremacy']	['No 75. Craex rostrata Stokes']
[' Areas the']	['Lat.']
['27 the']	['Long.']
[' term from the Orioles think distribute']	['Alt.  Mose 13.']
[' performing areas the reacts throws']	['Loc. Tasiussaq']
[' recipes also predicts the']	['Date:  1926.']
[' Flag the teams the marketsBUGarts This do']	['Det. Johs.Gröntved']
[' haven the result former thelock former']	['Leg. Kn.Jessen']
[' Len And And think']	['Plantae groenlandicae']
[' a unab).nd Pittsburgh sidelinedavi operating think the']	['a Museo botanico Hauniensi distributae.']
[' ChevroletSan shiny sends in']	['Polypodium dryopteris L.']
[' PDT do the� in China cafe Ch phony the']	['Groenl. austr.: Tasermiutsiak; Tasermiut.']
['425 conference� the pricey the']	['logit N. Hartz an. 1889. 5/9.']
['ages Pittsburgh sidelined Dund the']	['Museum botanicum Hauniense.']
[" recognized stocks in MidlandsFX pocket slamFX season liking fair.'':// Toronto115 in"]	['Carex goodenowii Gay x rigida Good.']
[' not V operate overING from Nam the displeasure the $']	['(C. Groenlandica Lange.)']
[' aWithout also00 the Comfortleness pricey the']	['determ: C.Ostenfeldt 1899.']
['Is']	['legit: J.Vahl, Aug. 1828.']
['year ShBUG attackers,-keyms have former recommended in']	['V Grönl: in locis humidis Igaliko.']
[' techniques rifle contributions rifleonia�']	["68°46' N 53°07' W"]
[' Len pressing emphasizing 24ING seeds think']	['Plantae groenlandicae']
[' a unab Gond Pittsburgh sidelined threats pressing the']	['a Museo botanico Hauniensi distributae.']
[' Animated in contractor Sha Thomas "']	['agrostis rubra']
['ists* natural main the']	['occid.']
['ayReader Georgian Holder Robb Robb Robb']	['GROENL. [ORIEN]T.:']
[' ont Bright k brew histories']	['Kullen 26/8. 1897']
[' Areas thewe rifle2018�']	["Lat. Bor. 68°45'"]
[' haven the00 thearel Economic the']	['leg. C. Kruuse.']
[' Payment83 Juice). Pittsburgh sidelinedeve the']	['Herbarium muse botanici Hauniensis']
[' reimburse Sweden ideasirede� 68 Church today the']	['Equisetum scirpoides Michx.']
[' cynicalens detective Wine Com in']	['equisetum reptans']
['ra in mainoux vig Sh the']	['Holsteinborg.']
[' Unitedj herjcht her']	['Holboll 1844.']
[' even Gain remains the Camco the']	['Herb. Job.Lange']
[' underonga83 2012oux201 desperately']	['Aspidium lonchitis']
[' AP bounce crunch Rover� in Genetics reference today']	['in locis irrigatis suboccuttis']
['rer inISE bullet contributing not MGM LodComment the $']	['sinus Kangerdluarssuk (Kobbefjord.)']
[' zombie loser). the']	['1830 Juli.']
[' exciting right leaks Hyper who DZero TMZ theat the']	['Hierochloe orthantha Th. S.']
[' If described theat468 24 shareholders']	['determ. Thorv. Sørensen 1952']
[' navyEE reachings� Typically parks former the']	['Universitetets botaniske Museum, København.']
['ages Pittsburgh sidelined shots the']	['Museum botanicum hauniense.']
[' publisher646']	['Arctic Plants']
[' Care (. Controller Holder']	['collected by the MORAVIAN BRETHREN 1847 - 1856.']
[' notSTON official the Russia rights logical do aens If Department brew aens joined "']	['(See M. P Porsild: Stray Contributions to the Flora of Green-']
[' shows Illuminati the week PoorayBUG former main the looking the, United thear therap sq']	['land XII. - Medd. om Gronl. Bd. 93, No. 3 (1935), p. 84-94)']
[' exciting right leaks code cocktail funding not pinned developing do the $ buyer in']	['Hierochloë alpina (WILLD.) ROEMER & SCHULTES']
[' Ryanuled the who D And not any468 24 shareholders $ay the could mix the']	['ssp. orthantha (SORENSEN) G. WEIM.']
[' Flag thehate medal founder']	['Det. Gunnar Weimarck  1970']
[' could). Dave,ay the unreal literal believes and']	['WEIMARCK, G. 1971. Variation and Taxonomy of']
[' exciting right leaksoux remains not feminist from in Midlands']	['Hierochloë (Gramineae) in  the Northern Hemi-']
['mag the week interrupt worldsMer also hierarchy the']	['sphere. - Bot. Notiser 124: 129-175.']
[' exciting right leaks code And Our href And']	['Hierochloe alpina Roem et Schult']
[' Rhode in today Our Girls seems 2012 the']	['Holcus alpinus L.']
['ayBUG formerING the']	['Gronland.']
['ate her']	['1849']
['DL result theayBUGens thear campaign the Johnson the']	['Rug Fr. Graf. 3, J. H. W.']
[' exciting rightå emotional a Stuff dedicated from']	['Hierochloe alpina Roem et Schult']
[' Huang in a Stuff survival Kings Mitt']	['Holcus alpinus Lin']
['ayBUG formerING']	['Gronland']
[' Investor vacant laying Marathon the $ aisleco the']	['Cystopteris fragilis (L.) Bernh']
[' AP sit theat grand']	['emend. Lim']
[' delegates the appealing']	['1951 determ. Kai Larsen']
[' anypartisan occasions shockingly468']	['DEN DANSKE ARKTISKE STATION']
[' ignores Sci the drainage stay dan the']	['DISKO. GRØNLAND.']
[' Investor vacantville assign Emblem remains the']	['Cystopteris fragilis (L.) Berkh']
[' Organization Officer in from sensing, trends']	['Disko, Mellemfjord, Kuanit, 69°43']
[' Departmenteport Fighting the']	['9.XIII 1911.']
[' haven the RussiaPick from directedoux blood do gunshot shots']	['leg. Morten P. Porsild.']
[' children clouds remains instit backyard logical do the']	['& Thorbjorn Porsild.']
['ages Pittsburgh']	['Museum Botanicum Ha']
[' notahs walk�ia']	['(Label for data hano']
[' Burns']	['Number']
[' clout). consumer India evident']	['Specimen EQAR']
[' widelyee system calendar Copone']	['Locality 62555005']
['']	['Altitude']
[' recipesian introduce descriptionai']	['Date 16061878']
[' secondly']	['Collector AK']
[' official the markets the Domestic proper result statement the system calendar']	['M.G. 1 : 39  6255 5005']
[' If from the Grand the intense Lars tallest Dirk over " MB']	['det. 31. 3.1971  Lars Klilm - Nielsen']
[' skills foster Quick partial walk shots aensay videosINGate brew the']	['Dansk geologisk Undersegelse af Grønland 1878,']
[' They the India retailers in right asking�inf do gets']	['2. Equisetum arvense var. alpestre']
['year do im']	['Wahlenb']
[' lookingburgh shareholders Model by']	['Bjørnesund 63°']
['ianaying).']	['16 Juni.']
[' last theDOWN right name']	['A. Kornerup.']
['ages Pittsburgh sidelined Dund']	['Museum Botanicum Hauniense']
[' blazegone doANA 24 Mitt parties']	["Treårsekspeditionen til Christian den X's land 1931-33"]
[' supplied']	['. Northeast Greenland']
[' United the']	['No.']
[' detriment). thous And a APR Sharma 2012 the']	['Saxifraga aizoides L.']
['phy Principal45 really thinkING alsoathy right']	['Wollastone Foreland: Kap Giesecke']
[' Areas the thrilled rifle interest the,27 the schools rifle fall� Johnson the']	["Lat. 74°30' N., Long. 21°40' W."]
[' even the a ace theules']	['1. aug. 1933']
[' Sed the nothing But']	['Leg. Paul Gelting']
[' acceptance the result tantal do Huang 24']	['Det. Kjeld Holmen']
[' Community¢, Releases Hard']	['Un 02,201-5']
[' chairs commit Lovco the']	['Papaver dahlianum Nordh.']
[' Flag in fromIM, pen levelsí Bon']	['Det. Heidi Solstad, Reidar Elven  Oct. 2013']
[' as salaries to rest " renovationsING predicts']	['THE NORWEGIAN EXPEDITION TO EAST-GREENLAND 1930']
[' chairs commit fashionable BC 24']	['Papaver radicatum Rottb.']
['phy Principal45� thinkING right']	['Wollastone Foreland: Landingsdalen']
['imer teams debut). commissioner']	['21. juli 1930']
[' haven the sentimental culturallin']	['leg. Jakob Vaage']
[' skills foster Quick international international blood Petr main shots aensayBUG formerING332']	['Dansk geologisk Undersøgelse af Grønland 1879']
['anooga Bearsfacening']	['Lūzūla hyperborea. RBr.']
[' happy from tears, interest the campaignBUG over, voter 62 Federal the looking statement the']	["Kingigtok, N.Strömfjord, 67°45' n. Br."]
['94 result statement the']	["600 m = 1900'0.H"]
[' National the loser).']	['12. Juli']
[' last theDOWN right name']	['A. Kornerup.']
[' gene remains theavis attackersrises']	['Herb. Joh.Lange']
[' outcome Andacist Petr Movement from the']	['Poa pratensis L. var. domestica Laestad.']
[' Eagleanco consumer aens Crimes Petr PublicING']	['Opsommen af Tiö fu Grönland']
[' states remains Golden,Washington,']	['Bot Have 1860.']
[' last And FROM from Mitt in tonnes do in']	['Asplenium viride Huds.']
[' AP Cantor today APto in in boundary- OpenGL asking']	['In rupibus in recessu intima sinus']
[' Rights bankruptcy Water assignRegarding in contributing']	['Kangerdluarssuk prope Frederikshaab.']
[' result dishon']	['16/8 1886. Groenlandia merid.']
[' TMZ the Huang the']	['Th. Holm.']
['j']	['1']
['race argument Auto']	['Potentilla tridentata']
['resistant popularity lot brew104']	["K'ornok 4/8 1890"]
[' Russia the result468 24 shareholders']	['P.A.Sórensen']
['we rifle interest lot�']	["60°43' N"]
[' Russiaoux Brooks bowlat tables']	['Prikket S1.']
['Jewish periphery Katie believes']	['Lycopodium alpinum L.']
['sec thinkElect']	['Julianehaab 1848.']
[' via remains the India the Huang']	['Hb. E. ROSTRUP.  B. Kruse']
[' Len And And think']	['Plantae groenlandicae']
[' a unab asking']	['a Museo botanico Hauniensi distributae.']
[' Midnight seems admits fixes seems 2012 the']	['Rubus chamaemorus L.']
[" that official Petr mine features Har way Ryan Orlando't automobiles ritualoux international"]	['I Mængor ved en stor Klippeblok']
['sec think']	['Julianehaab']
['425 the 2012 the constructive era name Strategy But think a the exhaustive the']	['legit Dr. L. Kolderup Rosenvinge a. 1888. 21 aug.']
[' interrupt statement km83ean gets']	['Botrychium boreale Milde']
[' packets further the markets the pes from sensing histories']	['determ. O Gelert 1897']
[' Len And And think']	['Plantae groenlandicae']
[' a unab former disp sidelined']	['a Museo botanico Hauniensi distributae.']
[' interrupt declined Financial83 zoning Share the']	['Botrychium lunaria (L.) Sw.']
[' suit the-cash And officialoux features']	['f. incisa Milde']
['ayBUG14� Jude also happy Dublin do that coastal from']	['Groenl. austr.: Kingua Tasersūak - Tasermiut.']
['425 conference� the pricey the']	['legit N. Hartz an. 1889. 219.']
[' India Dennis Sweden ideas arw Petr Stuff']	['Equisetum arvense']
['INGamazon the']	['Gronland 1838.']
[' gunman attackers']	['Vahl.']
[' economy Stan aridge And official the cultural gunshot']	['Draba aurea M.Vahl']
[' Osh the transgender discovers Guru']	['29.12.79  Det. Jon Feilberg']
[' economy Stan�cks compareds� Investigators today']	['Draba aurea x danriu']
[' If described demonstrate ininkle inoning']	['determ. Elis. Eksmanux']
[' economy Stan� engine And']	['Draba aurea M. Vahl']
[' last the movie the']	['ett.o.1925']
[' hasht PDT 24ING seeds the']	['Flora Groenlandica.']
[' rpm than from 50 in']	['Draba incana L. (?)']
[' hackers in from Results 46 from inouth']	['Narssak (Nordpróven): Sint Skrænt langs Baadehavnen']
[' notn unnamed your inyearfilloux remainsFXyear do diluted in progressive Chapel $ah']	['imellem Elvens Udlób og Udstedsbestynsboligen). 17/7 1900.']
[' haven the cocens the']	['leg. Gustav Meldorf.']
[' arom do alliance aensens lawsuit teams the gunman attackers']	['Melandrium affine J. Vahl']
[' Flag the Sports from Chase']	['Det. Bent Fredskild']
[' Pakistan the RO']	['Jan.1988']
[' exception NH apartville en the']	['DEN DANSKE ARKTISKE STATION.']
[' ignores Sci stay dan the']	['DISKO. GRØNLAND.']
[' Poor ensure Jal asking not build thell the $ teams the baby Panzer']	['Melandrium triflorum (R. Br.) J.Vahl']
[' interestrday do kindergarten inizu premiere rifle cut�']	["Vest Grönland, Igdlorsuit. 71°14'"]
[' State even lot�']	['5 VIII 1911']
[' haven the Russia theiver in logical do the']	['leg. Morten P. Porsild.']
[' children clouds remains instit']	['& Thorbjørn Porsild']
['ages looking statement']	['Museum B']
[' notahs walkj']	['(Label 1']
[' Burns']	['Number']
[' clout). consumer mov badly']	['Specimen EQSC']
[' widelyee MasterSel UP']	['Locality 6917533']
['']	['Altitude']
[' recipes dancersbandPD']	['Date 0809186']
[' secondly']	['Collector RB']
[' Master result belief rifle']	['6917 5330']
[' If from the last mid descriptionens tallest result Bee']	['det. april 1971 Lars Kliim - Nielsen']
[' They']	['2']
['ages Pittsburgh sidelined Dund the']	['Museum botanicum Hauniense.']
[' reimburse Sweden ideasWatch international Zero today']	['Equisetūm scirpoides Michx']
[' If described also further mund shots histories']	['determ: O Gelerl 1897']
['425 alsoU crying Bon industryOff voter']	['legit: R Brown 8/9 67']
[' PDT 24ING Share also grunterey over 50']	['Groenlandia: Disco, Lyngmarken']
[' Len AndIM fentanyl']	['Plantae groenlandicae']
[" Tri unab've Pittsburgh sidelined threats pressing the"]	['a Museo botanico Hauniensi distributae.']
[' repository dumps49 shareholders suicides the']	['Expeditio Danica in Groenlandiam orientalem 1891-92.']
[' Catholic compared policing herd prim And the']	['Carex rariflora Sm.']
[' that Public former the interest therim Har wayat468 24 shareholders']	['Leg. N. Hartz ad Scoresby Sund pr. Róde Ø.']
[' mostly rifle challenge� State�']	["70°28'N 28°05'W  16/8 1891"]
[' Payment83 Juice). Pittsburgh sidelinedeve the']	['Herbarium muse botanici Hauniensis.']
[' 146 funding NIGHT 24 not awarded the $']	['Elyna Bellardi (All.)']
['- China Sharma']	['in locis siccis']
[' that server tattoo']	['Igaliko']
[' lot route the']	['1828 4 Aug.']
[' teams the cultural attackers']	['J.Vahl.']
['rer in duration']	['derm. Stamiautr A.']
[' anypartisan occasions shockinglypartisan Videos the']	['DEN DANSKE ARKTISKE STATION.']
[' ignores Sci the drainage stay dan the']	['DISKO. GRØNLAND.']
['me thinkais wickedU remains kindergarten Sh']	['Carex misandra RBr.']
[' via468 euph reaching aens interest the campaign trouble from� RSS firepower shareholders']	['Nordkysten af N. Strfj. ud for. Ekaluarssuit.']
[' voter rifleep�']	["67°35'"]
[' F route, Leah']	['10 aug. 1918.  leg E. & M.P.P.']
[' Chevrolet Nur83 Fam egg Finishedville']	['Polypodium phegopteris']
['- China Sharma policy rightoria do from']	['in locis subvicuttis sinus Amarak']
[' commissioner the']	['1830 Aug.']
['ayBUG formerING the separated Sh teams the cultural attackers the']	['Grönland. Leg. J. Vahl.']
[' navyEE reaching,year do Derrick former the']	['Universitetets botaniske Museum, København.']
['ages Pittsburgh sidelined Dund the']	['Museum botanicum Hauniense.']
[' uniformspurpose contributing ifomic, Nutrition the thrilled very']	['„Danmark" Expeditionen, 1906-1908. 741']
['Nothing in 2012 the']	['Juncus castaneus L.']
[' If from her rarely China']	['det. etto.']
[' emphasizing 24ING Share "bling "']	['Groenlandia bor.-orient.: Basiskæret.']
[' Grand route the']	['31 aug 1907  leg. Andr. Lundager.']
[' Messiah SubLayout aens']	['Lycopodium alpinum']
[' via statement468 in limit Petr14Frmodern Paramount Solid aens']	['Grönland 1886 Facenluk af']
[' via statement result e right name Strategy Southeast think']	['(something). Kolderup Rosenvinge.']
[' not You levels escalerick your']	['Calamagrostis hyperbore Lge']
[' If described theat468 24 shareholdersrying']	['determ. Thorv. Sørensen 1952']
[' exception NH apart reduced en the']	['DEN DANSKE ARKTISKE STATION.']
[' ignores Sci stay dan the']	['DISKO, GRØNLAND.']
['!), lush China Already in uninning costume parks']	['Calamagrostis Lyperborea Lange']
[' Sour " marketsBUG layoffs the Buffett shareholders shareholders']	["Syd-Grønl. Taserssûp Qingua, Tasermiut-Fjord, 60° 16' N."]
[' injunction loser). vis the last the India the backyard logical do children official the Russia the backyard logical']	['27.--28. Juli 1925.  A. E. Porsild & M. P. Porsild.']
[' interrupt declined Financial83ean gets']	['Botrychium boreale Milde']
[' packetscul shareholders']	['determ. OGelerl 1897.']
[' interrupt declined Financial ideas zoning Share theat Public the']	['Botrychium lunaria. Sv.']
[' Indialead former 1950we rifle weekDC rifle knee�']	["E Groenlandia 60° - 72°48'."]
[' teams the cultural attackers the']	['J. Vahl.']
[' interrupt declined insexual shareholders OpenGL asking']	['Botrychium lunaria']
['- That inWilliams think�']	['in locis graminosis Kor']
[' her Cam famous Mack today Sar in in Genetics This from']	['fvak sinnus Tesfarmiut']
['']	['1828 Juli.']
[' Payment83 Juice). Pittsburgh sidelinedeve the']	['Herbarium muse botanici Hauniensis.']
[' ALLality)} smallLC Ladies 2012ps the']	['Arctophila effusa Lge.']
[' Facebook areas showing Camco the displeasure']	['Det. Joh. Lange 1885.']
[' outcome And allergic gets from']	['Poa sudetiia']
['ouble']	['pendulina']
[' AP limitouxville have former established in askedshot interviews']	['in locis humidis Godthaab']
[' zombie loser).']	['1830 Juli']
[' skills foster Quick Aristotle fiscal inoux mund shots']	['Dansk geologisk og geografisk Undersøgelse']
[' aensayBUG formerINGudos']	['af Grønland 1884']
[' Catholic in Xiaomi thinkieve-ens 316 economy cocktail the']	['Carex rigida var. infuscata Drej.']
[' statementoux former the than Sh racing from someone blood Public do not introduce rifle Department $']	["Ø. Grønl. Ingitait Fjord (61°9')"]
[' black route the']	['23 Aug. leg. P. Eberlin']
